#g2bword.1.0	17897
阿 卜	 R
阿 布	 ガ
阿 城市	 哎
阿 发表	 o
阿 伦	 
阿 佩	 ㄘ
阿 婆家	 Ca
阿 主席	 Du
阿 作出	 @X
埃 布	J ガ
埃 佩	J ㄘ
哎 呀	u r
癌 复发	砾 _o
癌 疗	砾 励
矮 矮	G G
矮 臂	G u
矮 的	G 
矮 杆	G 
矮 个	G 
矮 化	G て
矮 旧	G 侣
矮 马	G 皑
矮 麦草	G 沉
矮 屋	G 
矮 又	G S
艾 卜	 R
艾 发出	 oX
艾 格	 
艾 伦	 
艾 默	 q
爱 出汗	R X
爱 共产党	R @玻囊
爱 国家	R 瓣a
爱 家乡	R am
爱 美术	R N
爱 树	R 攫
安 杯	w M
安 撤出	w MX
安 发动机	w o笆诀
安 格	w 
安 回家	w ^a
安 提出	w 矗X
安 托	w Λ
安 溪	w 匪
安 遭受	w D
俺 回家	 ^a
俺 家	 a
俺 全家	 a
按 布	 ガ
按 当年	 讽~
按 国家	 瓣a
按 技术	 мN
按 家乡	 am
按 面额	 泵B
按 专家	 Ma
岸 发展	─ oi
岸 共识	─ @醚
岸 共同	─ @P
岸 共	─ @
岸 开发	─ }o
岸 学术	─ 厩N
岸 作家	─ @a
案 发表声明	 o砹n
案 发生	 oネ
案 发	 o
案 十万	 QU
案 属国	 妮瓣
案 提出异议	 矗X钵某
案 万	 U
昂 的	 
昂 等	 单
昂 迪	 }
昂 多	 h
昂 和	 M
昂 家长	 a
昂 将	 N
昂 两	 ㄢ
昂 洛	 
昂 娜	 R
昂 纳	 
昂 内	 ず
昂 起头	 _Y
昂 起	 _
昂 仁	 く
昂 少将	 ぶN
昂 市	 カ
昂 为	 
昂 席	 u
昂 扬	 喘
昂 总统	 `参
敖 伦	蔽 
奥 布	而 ガ
奥 格	而 
奥 共	而 @
奥 理事会主席	而 zㄆ|Du
奥 伦	而 
奥 托	而 Λ
奥 万	而 U
澳 发明	D o
澳 发现	D o{
澳 科学家	D 炀钱a
扒 出来	ザ Xㄓ
八 城市	K 哎
八 家	K a
八 舍	K 
巴 卜	ぺ R
巴 布	ぺ ガ
巴 出身	ぺ Xō
巴 出席	ぺ Xu
巴 格	ぺ 
巴 伦	ぺ 
巴 签署	ぺ 帽p
巴 苏	ぺ 默
巴 托	ぺ Λ
巴 之外	ぺ ぇ~
把 布达佩斯	р ガFㄘ吹
把 城市	р 哎
把 成千上万	р ΘdWU
把 出口商	р Xf坝
把 大家	р ja
把 道家	р Da
把 地板	р aO
把 发生	р oネ
把 发展	р oi
把 发	р o
把 饭菜	р 逗垫
把 扶持	р н
把 扶	р н
把 公共工程	р そ@u{
把 共产党	р @玻囊
把 共青团	р @C刮
把 共同	р @P
把 共	р @
把 国家	р 瓣a
把 海堤	р 出
把 技术监督	р мN菏服
把 技术员	р мN
把 技术	р мN
把 家庭	р ax
把 家	р a
把 甲板	р ヒO
把 坚持	р 绊
把 坚定	р 绊w
把 坚决	р 绊M
把 江苏	р 磕
把 开发	р }o
把 裤腿	р 壳L
把 名额	р WB
把 能够	р 喟
把 千万	р dU
把 签到簿	р 帽烀
把 签署	р 帽p
把 潜能	р 肩
把 情况	р 薄p
把 手头紧	р もY候
把 树丛	р 攫O
把 树立	р 攫ミ
把 树	р 攫
把 水土保持	р 簸gO
把 苏联	р 默p
把 特殊	р S
把 万	р U
把 违法	р Hk
把 五颜六色	р きCせ
把 西藏	р 杪
把 校舍	р 摘
把 学术交流	р 厩Nユy
把 严格	р Y
把 演出	р tX
把 秧苗	р 杯]
把 一家人	р @aH
把 医疗	р 洛励
把 艺术	р 美N
把 意识	р N醚
把 有限	р Τ
把 植树	р 从攫
把 自发	р 鄣o
把 自家	р 郛a
耙 完毕	 Ч拨
坝 火力发电厂	膨 酩Ooqt
白 布	フ ガ
白 城市	フ 哎
白 发	フ o
柏 秋	f 
百 出口	κ Xf
百 发还	κ o临
百 发	κ o
百 家用	κ aノ
百 家	κ a
百 万人	κ UH
摆 布	\ ガ
摆 出来	\ Xㄓ
摆 出去	\ Xh
摆 出	\ X
败 家	毖 a
班 采取	Z 蹦
班 出色	Z X
班 出	Z X
班 格	Z 
班 共	Z @
班 坚持	Z 绊
搬 回家	h ^a
般 奔驰	 b梗
般 地板	 aO
般 坚不可摧	 绊ぃiR
颁 布	{ ガ
板 安	O w
板 报	O 厨
板 比赛	O ゑ辽
板 便	O K
板 材	O 
板 长	O 
板 厂	O t
板 城	O 
板 的	O 
板 底下	O ┏U
板 地	O a
板 都	O 常
板 独唱	O W佰
板 管	O 恨
板 和	O M
板 化	O て
板 还	O 临
板 井	O か
板 可	O i
板 刻	O ㄨ
板 块	O 遏
板 链	O 渺
板 林	O L
板 猛击	O r阑
板 坯	O 蓑
板 皮	O ブ
板 平原	O キ
板 区	O 跋
板 上	O W
板 是	O O
板 头	O Y
板 为	O 
板 相	O 
板 亚军	O ㄈx
板 也	O ]
板 硬朗	O w
板 遮住	O B
板 组成	O 舱Θ
板 最后	O 程
瓣 露出	盲 SX
半 共和国	b @M瓣
办 板	快 O
办 城市	快 哎
办 出口商	快 Xf坝
办 出口	快 Xf
办 出	快 X
办 丰	快 伦
办 扶	快 н
办 婚前	快 Be
办 婚	快 B
办 技术	快 мN
办 家政学	快 aF厩
办 敬	快 q
办 名家	快 Wa
办 托	快 Λ
办 万	快 U
办 武术	快 ZN
办 西藏	快 杪
邦 格	ü 
帮 扶	腊 н
帮 技术	腊 мN
榜 公布	] そガ
胞 出席	M Xu
胞 共同努力	M @PVO
胞 共有	M @Τ
胞 共	M @
胞 回家	M ^a
胞 签	M 帽
包 价格	] 基
保 出售	O X扳
保 共青团	O @C刮
保 共	O @
保 国家元首	O 瓣aじ
保 国家	O 瓣a
保 技术	O мN
保 家	O a
堡 发表	躇 o
堡 宣布	躇 钮
饱 发愁	埂 oT
饱 阶段	埂 顶q
宝 杯	_ M
宝 有限公司	_ Τそq
抱 出	╆ X
抱 有希望	╆ Τ票
报 采访	厨 蹦X
报 出来	厨 Xㄓ
报 出	厨 X
报 发表	厨 o
报 公布	厨 そガ
报 共产党	厨 @玻囊
报 共同	厨 @P
报 国家	厨 瓣a
报 违法	厨 Hk
报 演出	厨 tX
报 指出	厨 X
暴 默	忌 q
爆 出	z X
爆 发出	z oX
杯 半	M b
杯 北欧	M _稼
杯 伯	M B
杯 茶	M 
杯 大	M j
杯 淡淡	M HH
杯 的	M 
杯 第三	M 材T
杯 钓鱼	M 敞辰
杯 冬季	M Vu
杯 读	M 弄
杯 短	M u
杯 盖	M \
杯 高尔夫球	M 蔼焊ひy
杯 高山	M 蔼s
杯 公开赛	M そ}辽
杯 冠军	M ax
杯 国际	M 瓣悔
杯 果汁	M Gツ
杯 喝	M 耻
杯 和	M M
杯 花	M 
杯 滑雪	M 菲撤
杯 技巧	M мォ
杯 奖	M 贱
杯 今天	M さぱ
杯 敬	M q
杯 竞走	M vǐ
杯 酒	M s
杯 决赛	M M辽
杯 篮球	M xy
杯 老	M ρ
杯 立	M ミ
杯 美国	M 瓣
杯 民族	M チ壁
杯 男子	M kl
杯 男	M k
杯 女子	M kl
杯 女	M k
杯 乒乓球	M モャy
杯 乒乓	M モャ
杯 汽车	M Tó
杯 青年	M C~
杯 青稞	M C\
杯 全国	M 瓣
杯 拳击赛	M 崩涣
杯 热门	M 荐
杯 软	M n
杯 赛	M 辽
杯 射击	M g阑
杯 声	M n
杯 首都	M 撼
杯 首	M 
杯 水平	M 籁
杯 水	M 
杯 速	M t
杯 穗	M J
杯 体操	M 砰巨
杯 体育	M 砰|
杯 田径赛	M バ|辽
杯 跳台	M 铬x
杯 土	M g
杯 团体	M 刮砰
杯 网球	M 呼y
杯 稳	M 铆
杯 我	M и
杯 武术	M ZN
杯 系列	M tC
杯 亚军	M ㄈx
杯 亚运	M ㄈB
杯 业	M ~
杯 移动	M 簿笆
杯 以	M H
杯 优秀	M uq
杯 优	M u
杯 游泳	M 村a
杯 羽毛球	M πをy
杯 羽	M π
杯 预赛	M w辽
杯 越野	M V偿
杯 则	M h
杯 这	M o
杯 争	M 
杯 中国	M い瓣
杯 中美	M い
杯 中	M い
杯 足球赛	M ìy辽
杯 足球	M ìy
杯 作为	M @
北 出现	_ X{
北 串联	_ 炅p
北 发生	_ oネ
北 丰	_ 伦
北 共同	_ @P
北 老家	_ ρa
北 伦	_ 
北 塞浦路斯	_ 峨隔吹
辈 出	晋 X
背 阿	I 
背 车	I ó
背 村	I 
背 到	I 
背 等	I 单
背 电话号码	I q杠腹X
背 二	I G
背 飞	I 
背 风	I 
背 回	I ^
背 夹	I Ж
背 进去	I ih
背 进	I i
背 井	I か
背 靠	I a
背 离	I 瞒
背 梁	I 辩
背 篓	I M
背 民族	I チ壁
背 铺盖	I Q\
背 起	I _
背 气	I 
背 去	I h
背 人	I H
背 山	I s
背 伤	I 端
背 上	I W
背 手	I も
背 熟	I 剪
背 她	I o
背 驼	I m
背 畜	I b
背 学校	I 厩
背 药箱	I 媚c
背 已	I w
背 影	I v
背 越	I V
背 在	I b
背 著	I 帝
贝 雕	ī J
贝 尔格	ī 焊
贝 格	ī 
贝 共	ī @
贝 托	ī Λ
备 并	称 }
备 采访	称 蹦X
备 采取	称 蹦
备 出席	称 Xu
备 出	称 X
备 斗争	称 矮
备 发放	称 o
备 技术	称 мN
备 结婚	称 挡B
备 举家	称 |a
备 签署	称 帽p
备 签	称 帽
备 情况	称 薄p
备 推出	称 崩X
被 逼	Q G
被 并	Q }
被 采掘	Q 蹦备
被 采纳	Q 蹦
被 查出	Q dX
被 出示	Q Xボ
被 发射	Q og
被 发现	Q o{
被 赶出	Q 话X
被 哥伦比亚	Q 舡郅瘿
被 国家	Q 瓣a
被 技术监督	Q мN菏服
被 家人	Q aH
被 家乡	Q am
被 坚守	Q 绊u
被 江苏	Q 磕
被 解释	Q 秆睦
被 开发	Q }o
被 列出	Q CX
被 妈妈	Q 洱洱
被 撵出	Q [X
被 扑灭	Q 汲防
被 施行手术	Q I妞獬N
被 收藏家	Q Μ旅a
被 树	Q 攫
被 苏联	Q 默p
被 塌	Q 厄
被 剃	Q c
被 推出	Q 崩X
被 婉	Q 胞
被 行家	Q 娈a
被 性格演员	Q ┦婧t
被 宣布	Q 钮
被 选出	Q 匡X
被 学术界	Q 厩N
被 压塌	Q 溃厄
被 治疗	Q v励
被 专家	Q Ma
奔 出	b X
苯 发生	f oネ
本 采用	セ 蹦ノ
本 出席	セ Xu
本 格	セ 
本 公报	セ そ厨
本 共和国	セ @M瓣
本 共	セ @
本 极为	セ 伐
本 家	セ a
本 课题	セ 揭D
本 疗法	セ 励k
本 亲笔签名	セ 克掸帽W
本 特殊	セ S
本 溪	セ 匪
本 指出	セ X
泵 采	 蹦
泵 出	 X
蹦 床	论 
蹦 高	论 蔼
蹦 乱跳	论 睹铬
迸 发出	n oX
逼 北京	G _ㄊ
逼 才	G ~
逼 得	G o
逼 和	G M
逼 还债	G 临杜
逼 蒋	G 奖
逼 进	G i
逼 你	G A
逼 平	G キ
逼 其	G ㄤ
逼 抢	G m
逼 人	G H
逼 森	G 此
逼 使	G ㄏ
逼 熟	G 剪
逼 她	G o
逼 退	G h
逼 著	G 帝
逼 走	G ǐ
比 昂	ゑ 
比 卜	ゑ R
比 布	ゑ ガ
比 采用	ゑ 蹦ノ
比 铲车	ゑ 藐ó
比 大丰收	ゑ j伦Μ
比 当年	ゑ 讽~
比 发生炉煤气	ゑ oネl费
比 格	ゑ 
比 国家	ゑ 瓣a
比 技术	ゑ мN
比 家	ゑ a
比 价格	ゑ 基
比 江苏	ゑ 磕
比 开发	ゑ }o
比 舍	ゑ 
比 托儿所	ゑ Λㄠ┮
比 托	ゑ Λ
比 宣布	ゑ 钮
比 选出	ゑ 匡X
笔 呆帐	掸 bb
笔 额外	掸 B~
笔 共	掸 @
笔 签	掸 帽
笔 书法家	掸 血ka
笔 数额	掸 计B
碧 溪	貉 匪
毕 国家	拨 瓣a
毕 宣布	拨 钮
必 家	ゲ a
必 坚	ゲ 绊
辟 出	@ X
辟 公共	@ そ@
辟 苏维埃	@ 默蝴J
壁 雕	纠 J
壁 露出	纠 SX
臂 焊	u k
边 并	娩 }
边 铲	娩 藐
边 出血	娩 X
边 发表	娩 o
边 发呆	娩 ob
边 发动	娩 o笆
边 扶	娩 н
边 敬	娩 q
边 开发	娩 }o
边 流下	娩 yU
边 拿出	娩 偿X
边 拍照	娩 ╃酚
边 签名	娩 帽W
边 树木	娩 攫れ
边 吸出	娩 lX
编 采	s 蹦
编 出版	s X
编 出	s X
编 发	s o
扁 竹	 λ
便 背	K I
便 逼	K G
便 出现	K X{
便 发出	K oX
便 发起	K o_
便 发现	K o{
便 紧锣密鼓	K 候rK躬
便 露出	K SX
便 浓妆	K @З
便 伸出	K X
便 掏出	K 鼻X
便 宣布	K 钮
便 有意识	K ΤN醚
便 越发	K Vo
变 魔术	跑 ]N
辨 出自	侩 X
辩 情况	G 薄p
遍 布	M ガ
遍 千山万水	M dsU
标 发出	夹 oX
标 签	夹 帽
表 并	 }
表 测试	 代刚
表 发放	 o
表 露出	 SX
别 出	O X
别 家	O a
别 完毕	O Ч拨
斌 出席	y Xu
斌 出	y X
斌 发	y o
斌 能够	y 喟
斌 提出	y 矗X
斌 指出	y X
宾 出色	猾 X
宾 挺身而出	猾 绩τX
宾 走下	猾 ǐU
兵 发挥	L o揣
兵 阶段	L 顶q
兵 舍	L 
兵 殊荣	L 砗a
兵 资格	L 戈
冰 技术	B мN
冰 糖葫芦	B }脯莫
冰 指出	B X
病 发生	f oネ
病 发	f o
病 家	f a
病 坚持	f 绊
病 疗	f 励
病 情况	f 薄p
病 塌	f 厄
病 退出	f hX
病 预测	f w代
病 专家	f Ma
病 作出	f @X
并 阿拉伯	} ┰B
并 安排	} w逼
并 按照	} 龇
并 按	} 
并 把	} р
并 白内障	} フず毁
并 拜访	} 舫X
并 拜会	} 舴|
并 颁发	} {o
并 颁	} {
并 伴	} 
并 办理	} 快z
并 办妥	} 快Т
并 办	} 快
并 帮助	} 腊U
并 帮	} 腊
并 保持	} O
并 保护	} O@
并 保留	} Od
并 保障	} O毁
并 保证	} O谍
并 报告	} 厨i
并 报	} 厨
并 备	} 称
并 被	} Q
并 奔赴	} bu
并 本著	} セ帝
并 避免	} 磷K
并 编辑	} s胯
并 编	} s
并 标明	} 夹
并 标	} 夹
并 表达	} 砉F
并 表明	} 愆
并 表示	} 恁
并 表彰	} 砉
并 拨	} 挤
并 博得	} 痴o
并 驳斥	} 婚ジ
并 补	} 干
并 不大	} ぃj
并 不到	} ぃ
并 不断	} ぃ_
并 不关心	} ぃ闽み
并 不见	} ぃǎ
并 不景气	} ぃ春
并 不时	} ぃ
并 不太	} ぃび
并 不停	} ぃ氨
并 不要	} ぃn
并 不意	} ぃN
并 不在意	} ぃbN
并 不只是	} ぃuO
并 不只	} ぃu
并 不准	} ぃ
并 不	} ぃ
并 步	} B
并 部分	} 场だ
并 部署	} 场p
并 裁减	} 掉搭
并 采纳	} 蹦
并 采取	} 蹦
并 采用	} 蹦ノ
并 参观	} 把[
并 参加	} 把[
并 参与	} 把P
并 参	} 把
并 草	} 
并 层层	} hh
并 查明	} d
并 查阅	} d\
并 查	} d
并 产生	} 玻ネ
并 产	} 玻
并 阐明	} 哪
并 阐述	} 哪z
并 猖狂	} sg
并 长春	} K
并 超过	} WL
并 超越	} WV
并 抄	} й
并 撤销	} MP
并 彻底	} 过┏
并 称为	} 嘿
并 称赞	} 嘿g
并 称	} 嘿
并 成功	} Θ\
并 成立	} Θミ
并 成	} Θ
并 呈	} e
并 惩治	} gv
并 诚恳	} 港赖
并 承办	} ┯快
并 承包	} ┯]
并 承担	} ┯踞
并 承接	} ┯钡
并 承诺	} ┯空
并 承认	} ┯{
并 持有	} Τ
并 充分	} Rだ
并 充实	} R龟
并 冲击	} R阑
并 抽空	} ┾
并 初步	} 歙B
并 出版	} X
并 出动	} X笆
并 出席	} Xu
并 出现	} X{
并 出	} X
并 处	} B
并 传播	} 肚冀
并 创纪录	} 承隹
并 创造	} 承y
并 创	} 承
并 从事	} qㄆ
并 从中	} qい
并 从	} q
并 促进	} Pi
并 促	} P
并 摧毁	} R反
并 存	} s
并 达成	} FΘ
并 达到	} F
并 答复	} 氮_
并 答应	} 氮莱
并 打击	} ゴ阑
并 打开	} ゴ}
并 打破	} ゴ}
并 打入	} ゴJ
并 打死	} ゴ
并 打算	} ゴ衡
并 打	} ゴ
并 大力	} jO
并 大声疾呼	} jneI
并 大声	} jn
并 大	} j
并 带动	} a笆
并 带头	} aY
并 带	} a
并 代表	} N
并 代	} N
并 逮捕	} e
并 担任	} 踞ヴ
并 担	} 踞
并 单方面	} 虫よ
并 当场	} 讽初
并 当即	} 讽Y
并 当选	} 讽匡
并 导致	} 旧P
并 到	} 
并 德	} w
并 得到	} o
并 得	} o
并 的	} 
并 登	} n
并 等待	} 单
并 敌对	} 寄癸
并 第三	} 材T
并 第一	} 材@
并 点火	} I
并 吊	} Q
并 调动	} 秸笆
并 调整	} 秸俱
并 叮嘱	} m篷
并 定期	} w戳
并 定下	} wU
并 定	} w
并 动员	} 笆
并 督促	} 服P
并 断绝	} _荡
并 断	} _
并 对外	} 癸~
并 对	} 癸
并 敦促	} 窗P
并 多	} h
并 夺	} 管
并 额	} B
并 而	} τ
并 发表演说	} o砗t弧
并 发表	} o
并 发出	} oX
并 发动	} o笆
并 发挥	} o揣
并 发掘	} o备
并 发展	} oi
并 发	} o
并 罚款	} @蹿
并 翻译	} 陆亩
并 反对	} は癸
并 反映	} はM
并 反	} は
并 访问	} X拜
并 放弃	} 癖
并 放映	} 瘳M
并 放	} 
并 非	} D
并 废除	} o埃
并 分别	} だO
并 分	} だ
并 奋勇	} 灸i
并 风趣	} 方
并 奉命	} ^R
并 否定	} _w
并 否认	} _{
并 俘虏	} R父
并 服务	} A叭
并 辅	} 徊
并 赴	} u
并 付出	} IX
并 付款交货	} I蹿ユf
并 付诸实施	} I窖龟I
并 负责	} td
并 富有	} IΤ
并 附上	} W
并 附	} 
并 改变	} э跑
并 改革	} э
并 改善	} э到
并 肝硬化	} xwて
并 感受	} P
并 感谢	} P谅
并 敢	} 幢
并 高度	} 蔼
并 高兴	} 蔼砍
并 搞	} d
并 告诫	} i|
并 告诉	} iD
并 各	} U
并 给予	} 倒ぉ
并 给	} 倒
并 根据	} 诰
并 更	} 
并 工作	} u@
并 公布	} そガ
并 公开	} そ}
并 公司	} そq
并 公	} そ
并 共同努力	} @PVO
并 购买	} 潦R
并 估价	} 艋
并 鼓励	} 躬y
并 固定	} Tw
并 挂	} 本
并 关闭	} 闽超
并 关心	} 闽み
并 观看	} [
并 光荣	} a
并 规定	} Ww
并 归还	} k临
并 轨	} y
并 诡	} 皋
并 海	} 
并 号召	} 腹l
并 核	} 
并 和	} M
并 合理	} Xz
并 合	} X
并 很	} 
并 狠	} 
并 虹	} i
并 后	} 
并 呼喊	} I驰
并 呼	} I
并 互相	} が
并 互	} が
并 欢迎	} w
并 还	} 临
并 挥	} 揣
并 恢复	} 齑_
并 回答	} ^氮
并 回到	} ^
并 会见	} |ǎ
并 会同	} |P
并 会晤	} |编
并 会	} |
并 汇	} 蹲
并 绘	} 酶
并 活跃	} ∨D
并 获得	} 莉o
并 获	} 莉
并 或	} ┪
并 基金	} 膀
并 积极	} n伐
并 集中	} 栋い
并 及时	} の
并 即席	} Yu
并 寄	} H
并 计划	} p购
并 计	} p
并 继承	} ~┯
并 继续	} ~尿
并 加紧	} [候
并 加快	} [е
并 加强	} [j
并 加入	} [J
并 加速	} [t
并 加以	} [H
并 驾	} r
并 监督	} 菏服
并 坚持不懈	} 绊ぃ居
并 坚持	} 绊
并 坚决	} 绊M
并 兼任	} 荪
并 肩	} 
并 检讨	} 浪Q
并 柬埔寨	} ZH闺
并 简	} 虏
并 剪彩	} 芭m
并 剪贴	} 芭K
并 减	} 搭
并 鉴	} 懦
并 见	} ǎ
并 建立	} 廿
并 建议	} 啬
并 建造	} 爻y
并 建	} 
并 将就	} NN
并 将	} N
并 讲	} 量
并 降低	} 哀C
并 交还	} ユ临
并 交换	} ユ传
并 交流	} ユy
并 交	} ユ
并 缴	} 煤
并 教会	} 毙|
并 教	} 毙
并 接受	} 钡
并 竭力	} 很O
并 结合	} 挡X
并 结	} 挡
并 解除	} 秆埃
并 解答	} 秆氮
并 解决	} 秆M
并 解散	} 秆床
并 解	} 秆
并 借以	} 丧H
并 借	} 
并 介绍	} ざ残
并 紧握	} 候搐
并 进入	} iJ
并 进行	} i
并 进一步	} i@B
并 进	} i
并 禁止	} Tゎ
并 近	} 
并 尽可能	} 荷i
并 尽力	} 荷O
并 尽	} 荷
并 经常	} g`
并 经过	} gL
并 经营	} g犁
并 经	} g
并 警告	} 牡i
并 纠正	} 去
并 就	} N
并 举行	} |
并 举	} |
并 拒绝	} ┶荡
并 据此	} 沮
并 具备	} ㄣ称
并 具体	} ㄣ砰
并 具有	} ㄣΤ
并 具	} ㄣ
并 捐款	} 酱
并 捐献	} 侥m
并 决定	} Mw
并 决心	} Mみ
并 决	} M
并 均	} А
并 开办	} }快
并 开除	} }埃
并 开导	} }旧
并 开动	} }笆
并 开发	} }o
并 开设	} }]
并 开始	} }l
并 开通	} }q
并 开	} }
并 刊登	} Zn
并 看	} 
并 考虑	} σ{
并 靠近	} a
并 科威特	} 飓炉S
并 可能	} i
并 可以	} iH
并 可	} i
并 渴望	} 戴辨
并 扣除	} Ι埃
并 困难	} x螟
并 扩大	} Xj
并 扩建	} X
并 扩展	} Xi
并 理解	} z秆
并 利用	} Qノ
并 立即	} ミY
并 立	} ミ
并 力	} O
并 联合	} pX
并 连任	} sヴ
并 连声	} sn
并 连续	} s尿
并 连夜	} s]
并 两	} ㄢ
并 了解	} F秆
并 了	} F
并 列为	} C
并 列	} C
并 劣势	} H墩
并 临时	} {
并 领取	} 烩
并 另一	} t@
并 留	} d
并 流传	} y肚
并 流	} y
并 拢	} l
并 录	} 魁
并 陆续	} 嘲尿
并 率先	} v
并 率	} v
并 略	} 菠
并 落实	} 辅龟
并 落	} 辅
并 埋	} I
并 买来	} Rㄓ
并 茂	} Z
并 没有	} SΤ
并 没	} S
并 每年	} C~
并 每	} C
并 免费	} KO
并 免	} K
并 明确	} T
并 鸣	} 伙
并 名单	} W虫
并 名	} W
并 命令	} RO
并 命名	} RW
并 命	} R
并 谋	} 垦
并 目标	} ヘ夹
并 拿出	} 偿X
并 拿	} 
并 纳入	} 扦J
并 能	} 
并 拟定	} 览w
并 拟订	} 览q
并 拟	} 览
并 努力	} VO
并 派遣	} ；
并 派	} 
并 盘	} L
并 判	} P
并 跑	} ]
并 培	} 蚌
并 陪	} 抄
并 配备	} t称
并 配合	} tX
并 配	} t
并 批量	} уq
并 批评	} у蝶
并 聘请	} u叫
并 评价	} 蝶基
并 评	} 蝶
并 颇有	} 会Τ
并 破坏	} }a
并 迫使	} ㄏ
并 普遍	} 炊M
并 期待	} 戳
并 期望	} 戳辨
并 其	} ㄤ
并 起来	} _ㄓ
并 起	} _
并 企图	} 瓜
并 企业	} ~
并 签署	} 帽p
并 签约	} 帽
并 签	} 帽
并 谴责	} 宁d
并 强调	} j秸
并 强化	} jて
并 抢	} m
并 切断	} ち_
并 切实	} ち龟
并 且	} B
并 侵犯	} Iデ
并 侵入	} IJ
并 亲手	} 克も
并 亲自	} 克
并 青光眼	} C泊
并 青海	} C
并 请	} 叫
并 趋势	} 镣墩
并 取得	} o
并 取消	} 
并 劝	} U
并 确保	} TO
并 确定	} Tw
并 确认	} T{
并 燃放	} U
并 让	} 琵
并 热烈	} 荐P
并 热情	} 荐薄
并 任命	} ヴR
并 任	} ヴ
并 认识	} {醚
并 认为	} {
并 认真	} {u
并 日益	} らq
并 荣	} a
并 容忍	} eг
并 入	} J
并 三	} T
并 散发	} 床o
并 商定	} 坝w
并 上升	} Wど
并 摄	} 尼
并 设立	} ]ミ
并 设	} ]
并 深入	} `J
并 深信	} `H
并 审查	} fd
并 审议	} f某
并 声称	} n嘿
并 声明	} n
并 生产	} ネ玻
并 施放	} I
并 十分	} Qだ
并 时	} 
并 实地考察	} 龟aσ诡
并 实施	} 龟I
并 实现	} 龟{
并 实行	} 龟
并 矢	} ペ
并 使用	} ㄏノ
并 使	} ㄏ
并 事先	} ㄆ
并 适当	} A讽
并 适时	} A
并 释放	} 睦
并 市场	} カ初
并 视察	} 跌诡
并 试图	} 刚瓜
并 收到	} Μ
并 收回	} Μ^
并 收集	} Μ栋
并 收	} Μ
并 手段	} もq
并 手续	} も尿
并 首先	} 亥
并 授权	} 甭v
并 授予	} 甭ぉ
并 受到	} 
并 受	} 
并 输入	} 块J
并 数	} 计
并 刷新	} 攴s
并 顺利	} 抖Q
并 说明	} 弧
并 说	} 弧
并 送	} e
并 搜集	} j栋
并 肃清	} 德M
并 算	} 衡
并 随时通报	} H沙q厨
并 随著	} H帝
并 随	} H
并 索取	} 哩
并 所	} ┮
并 他国	} L瓣
并 抬	} ╋
并 谈到	} 酵
并 探索	} 贝
并 探讨	} 贝Q
并 糖尿病	} }Эf
并 掏出	} 鼻X
并 讨论	} Q阶
并 特别	} SO
并 特地	} Sa
并 特	} S
并 提出	} 矗X
并 提供	} 矗ㄑ
并 提交	} 矗ユ
并 提前	} 矗e
并 提醒	} 矗眶
并 提	} 矗
并 题	} D
并 体	} 砰
并 填写	} 恶g
并 听取	} 钮
并 停止	} 氨ゎ
并 通报	} q厨
并 通过	} qL
并 通知	} q
并 同意	} PN
并 同	} P
并 投入	} щJ
并 投资	} щ戈
并 投	} щ
并 团结	} 刮挡
并 推出	} 崩X
并 推动	} 崩笆
并 推广	} 崩s
并 推进	} 崩i
并 推举	} 崩|
并 推行	} 崩
并 推	} 崩
并 吞	} ]
并 托	} Λ
并 挖掘	} 醣
并 外国	} ~瓣
并 完成	} ЧΘ
并 完全	} Ч
并 完善	} Ч到
并 完整	} Ч俱
并 挽回	} 睛^
并 网	} 呼
并 往	} ┕
并 威胁	} 炉
并 唯一	} 斑@
并 为此	} 唉
并 为	} 
并 维持	} 蝴
并 维护	} 蝴@
并 委	} e
并 未	} ゼ
并 慰问	} 饥拜
并 稳定	} 铆w
并 问题	} 拜D
并 无视	} L跌
并 无效	} L
并 无	} L
并 吸收	} lΜ
并 希图	} 乒
并 希望	} 票
并 悉心	} xみ
并 细	} 灿
并 先后	} 
并 献花	} m
并 献身	} mō
并 限期	} 戳
并 相继	} 勰~
并 相信	} 郢H
并 相应	} 劾
并 相	} 
并 镶嵌	} ^O
并 镶	} ^
并 详细	} 冈灿
并 想	} Q
并 享受	} ㄉ
并 享有	} ㄉΤ
并 向	} V
并 削减	} d搭
并 销毁	} P反
并 销售	} P扳
并 消除	} 埃
并 消化	} て
并 小心	} pみ
并 协调	} 蠼
并 协助	} 螫U
并 写信	} gH
并 写	} g
并 欣赏	} Y洁
并 新	} s
并 形成	} 桅
并 行之有效	} 妞Е钞
并 行	} 
并 修改	} 拽
并 修理	} 撞z
并 虚心	} 店み
并 许诺	} \空
并 蓄	} W
并 宣布	} 钮
并 宣称	} 藕
并 宣告	} 脓i
并 选出	} 匡X
并 选定	} 匡w
并 选举	} 匡|
并 选派	} 匡
并 选择	} 匡拒
并 选	} 匡
并 寻求	} MD
并 迅速	} ǔt
并 压缩	} 溃Y
并 严格	} Y
并 严正	} Yタ
并 严	} Y
并 研究	} 悒s
并 研	} 
并 演变	} t跑
并 宴请	} b叫
并 邀请	} 淋叫
并 咬住	} r
并 要求	} nD
并 要	} n
并 耶路撒冷	} C隔蓟N
并 也	} ]
并 一贯	} @e
并 一举	} @|
并 一律	} @
并 一一	} @@
并 一直	} @
并 一致	} @P
并 一	} @
并 依靠	} ㄌa
并 依托	} ㄌΛ
并 依仗	} ㄌM
并 依照	} ㄌ酚
并 依	} ㄌ
并 伊拉克	} レ┰J
并 移交	} 簿ユ
并 已出版	} wX
并 已经	} wg
并 已	} w
并 以此	} H
并 以来	} Hㄓ
并 以色列	} H猞C
并 以	} H
并 译	} 亩
并 因此	} ]
并 因	} ]
并 引导	} ま旧
并 引进	} まi
并 引起	} ま_
并 引用	} まノ
并 印发	} Lo
并 应接	} 莱钡
并 应用	} 莱ノ
并 影响	} vT
并 拥有	} 局Τ
并 涌	} F
并 用	} ノ
并 由衷	} パJ
并 由	} パ
并 有机会	} Τ诀|
并 有所	} Τ┮
并 有希望	} Τ票
并 有益	} Τq
并 有	} Τ
并 于	} _
并 愉快	} rе
并 予	} ぉ
并 与其	} Pㄤ
并 与	} P
并 吁	} S
并 预定	} ww
并 预料	} w
并 原则	} 飓h
并 圆满	} 蛾骸
并 远	} 环
并 愿意	} @N
并 愿	} @
并 越过	} VL
并 阅读	} \弄
并 允许	} す\
并 运用	} Bノ
并 运	} B
并 酝酿	} 吝C
并 再次	} AΩ
并 再度	} A
并 再三叮嘱	} ATm篷
并 在场	} b初
并 在此	} b
并 在	} b
并 赞赏	} g洁
并 赞扬	} g喘
并 遭到	} D
并 遭受	} D
并 造成	} yΘ
并 责	} d
并 增加	} W[
并 增进	} Wi
并 增强	} Wj
并 曾	} 纯
并 赠送	} 秘e
并 展开	} i}
并 展示	} iボ
并 展	} i
并 占领	} 烩
并 占有	} Τ
并 战	} 驹
并 掌握	} x搐
并 帐户	} bめ
并 找到	} т
并 召开	} l}
并 这	} o
并 真正	} uタ
并 针对	} w癸
并 征	} ┖
并 争取	} Ж
并 正式	} タΑ
并 正在	} タb
并 正	} タ
并 支持	} や
并 之后	} ぇ
并 执行	} 磅
并 指出	} X
并 指定	} w
并 指示	} ボ
并 指责	} d
并 指著	} 帝
并 志	} в
并 致力	} PO
并 致谢	} P谅
并 致	} P
并 制定	} 瞟w
并 制度	} 瞰
并 制止	} 瞍
并 制作	} 瞌@
并 制	} 
并 中断	} い_
并 衷心	} Jみ
并 终	} 沧
并 重点	} I
并 重叠	} |
并 重申	} ビ
并 重视	} 跌
并 重新	} s
并 重	} 
并 逐步	} vB
并 逐渐	} v亥
并 嘱咐	} 篷J
并 主持	} D
并 主动	} D笆
并 主权	} Dv
并 主要	} Dn
并 主张	} Di
并 主	} D
并 著手	} 帝も
并 注意	} `N
并 注重	} `
并 注	} `
并 祝	} 
并 抓住	} ъ
并 专门	} M
并 转达	} 锣F
并 转交	} 锣ユ
并 转	} 锣
并 撰写	} 级g
并 装备	} 杆称
并 装修	} 杆
并 追究	} ls
并 准	} 
并 自动	} 郯
并 自费	} 鄱O
并 自己	} 郅v
并 自主	} 邾D
并 综合	} 侯X
并 总结	} `挡
并 走	} ǐ
并 阻碍	} 锚
并 阻挠	} 几
并 组成	} 舱Θ
并 组织	} 舱麓
并 最后	} 程
并 最终	} 程沧
并 尊重	} L
并 遵守	} 宽u
并 做	} 暗
并 作出	} @X
并 作为	} @
并 作	} @
播 出	冀 X
播 发	冀 o
拨 出	挤 X
波 并	i }
波 格	i 
波 签署	i 帽p
波 苏	i 默
波 指出	i X
波 治疗	i v励
博 采	痴 蹦
博 格	痴 
博 托	痴 Λ
勃 发现	k o{
勃 发	k o
勃 伦	k 
勃 主席	k Du
伯 杯	B M
伯 格	B 
伯 伦	B 
伯 托	B Λ
捕 回家	 ^a
卜 达	R F
卜 道	R D
卜 等	R 单
卜 杜	R 
卜 会	R |
卜 教授	R 毙甭
卜 杰	R 城
卜 拉	R ┰
卜 恰	R 
卜 素	R 
卜 校长	R 摘
卜 一	R @
卜 余	R E
卜 玉	R ド
卜 昭	R L
卜 之	R ぇ
补 发	干 o
补 树	干 攫
埠 平板玻璃	梆 キO良
不 采取	ぃ 蹦
不 超出	ぃ WX
不 撤出	ぃ MX
不 出产	ぃ X玻
不 出来	ぃ Xㄓ
不 出门	ぃ X
不 出去	ぃ Xh
不 出头	ぃ XY
不 出问题	ぃ X拜D
不 出席	ぃ Xu
不 出现	ぃ X{
不 出血	ぃ X
不 出	ぃ X
不 动手术	ぃ 笆もN
不 发出	ぃ oX
不 发达	ぃ oF
不 发工资	ぃ ou戈
不 发烧	ぃ oN
不 发生	ぃ oネ
不 发展	ぃ oi
不 发	ぃ o
不 丰	ぃ 伦
不 公布	ぃ そガ
不 规格	ぃ W
不 合格	ぃ X
不 回家	ぃ ^a
不 及格	ぃ の
不 坚持	ぃ 绊
不 坚决	ぃ 绊M
不 降格	ぃ 爱
不 降雨	ぃ 矮B
不 紧张	ぃ 候i
不 可预测	ぃ iw代
不 扣帽子	ぃ ΙUl
不 明显	ぃ 陪
不 能够	ぃ 喟
不 佩服	ぃ ㄘA
不 佩	ぃ ㄘ
不 平常	ぃ キ`
不 签	ぃ 帽
不 舍	ぃ 
不 说出	ぃ 弧X
不 提出异议	ぃ 矗X钵某
不 提出	ぃ 矗X
不 突出	ぃ 馥X
不 万分	ぃ Uだ
不 违背	ぃ HI
不 违犯	ぃ Hデ
不 想家	ぃ Qa
不 严格	ぃ Y
不 遭受	ぃ D
不 种树	ぃ 贺攫
不 作出	ぃ @X
布 阿	ガ 
布 埃	ガ J
布 保护	ガ O@
布 必须	ガ ゲ斗
布 便	ガ K
布 勃	ガ k
布 不	ガ ぃ
布 产量	ガ 玻q
布 厂	ガ t
布 称赞	ガ 嘿g
布 城	ガ 
布 成	ガ Θ
布 次	ガ Ω
布 搭	ガ f
布 达	ガ F
布 带子	ガ al
布 带	ガ a
布 当	ガ 讽
布 到	ガ 
布 道	ガ D
布 德	ガ w
布 的	ガ 
布 等	ガ 单
布 迪	ガ }
布 地区	ガ a跋
布 第	ガ 材
布 点	ガ I
布 杜	ガ 
布 对	ガ 癸
布 尔	ガ 焊
布 法令	ガ kO
布 范	ガ S
布 防	ガ 
布 放	ガ 
布 干	ガ F
布 高速公路	ガ 蔼tそ隔
布 革	ガ 
布 格	ガ 
布 各国	ガ U瓣
布 各	ガ U
布 公	ガ そ
布 规律	ガ W
布 国家	ガ 瓣a
布 哈	ガ 
布 汗	ガ 
布 和气	ガ M
布 和	ガ M
布 合著	ガ X帝
布 赫	ガ 划
布 很	ガ 
布 后	ガ 
布 基	ガ 膀
布 及	ガ の
布 贾	ガ 鸽
布 建设	ガ 爻]
布 江	ガ 
布 胶鞋	ガ 溅c
布 街头巷尾	ガ 刁Y学
布 介绍	ガ ざ残
布 今天	ガ さぱ
布 经济	ガ g蕾
布 局	ガ Ы
布 卡	ガ d
布 开发	ガ }o
布 科	ガ 
布 可	ガ i
布 克	ガ J
布 宽广	ガ es
布 拉	ガ ┰
布 莱	ガ 弟
布 赖	ガ 苦
布 兰	ガ 孽
布 缆	ガ l
布 朗	ガ 
布 老虎	ガ ρ
布 勒	ガ 扒
布 雷	ガ p
布 理论上	ガ z阶W
布 里	ガ 
布 利	ガ Q
布 力	ガ O
布 联盟	ガ p幅
布 了	ガ F
布 列	ガ C
布 临时	ガ {
布 隆	ガ 订
布 卢	ガ c
布 鲁	ガ |
布 吕	ガ f
布 伦	ガ 
布 罗	ガ 霉
布 洛	ガ 
布 满	ガ 骸
布 盟	ガ 幅
布 棉鞋	ガ 粗c
布 纳	ガ 
布 棚	ガ 醋
布 匹	ガ で
布 起草	ガ _
布 前	ガ e
布 切	ガ ち
布 钦	ガ 窜
布 琴	ガ ^
布 琼	ガ 茫
布 穷	ガ a
布 区	ガ 跋
布 全国	ガ 瓣
布 全市	ガ カ
布 全	ガ 
布 确定	ガ Tw
布 仁	ガ く
布 如此	ガ p
布 萨	ガ 履
布 塞	ガ 峨
布 赛	ガ 辽
布 三	ガ T
布 散	ガ 床
布 山	ガ s
布 衫	ガ m
布 设	ガ ]
布 生产线	ガ ネ玻u
布 生产	ガ ネ玻
布 省	ガ 
布 施行	ガ I
布 十分	ガ Qだ
布 时	ガ 
布 什	ガ ぐ
布 实施	ガ 龟I
布 世界	ガ @
布 是	ガ O
布 氏	ガ ん
布 说	ガ 弧
布 斯	ガ 吹
布 寺	ガ x
布 苏	ガ 默
布 特	ガ S
布 提	ガ 矗
布 条	ガ 兵
布 停火令	ガ 氨酯O
布 同	ガ P
布 投资	ガ щ戈
布 图	ガ 瓜
布 托	ガ Λ
布 瓦	ガ ニ
布 韦	ガ 
布 为首	ガ 碍
布 为	ガ 
布 委员会	ガ e|
布 吸收	ガ lΜ
布 下	ガ U
布 现任	ガ {ヴ
布 现在	ガ {b
布 香港	ガ 淮
布 协商	ガ 蟀
布 谢	ガ 谅
布 行业	ガ 娣~
布 徐徐	ガ }}
布 宣布	ガ 钮
布 亚	ガ ㄈ
布 也	ガ ]
布 一	ガ @
布 依	ガ ㄌ
布 衣	ガ 
布 已	ガ w
布 以来	ガ Hㄓ
布 由	ガ パ
布 于	ガ _
布 与	ガ P
布 约克	ガ J
布 约	ガ 
布 在	ガ b
布 增	ガ W
布 扎	ガ 蚕
布 展览	ガ i凝
布 遮	ガ B
布 这	ガ o
布 浙江	ガ 
布 政	ガ F
布 之	ガ ぇ
布 制	ガ 
布 中华	ガ い地
布 著	ガ 帝
布 专利	ガ MQ
布 状况	ガ p
布 兹	ガ 
布 总理	ガ `z
布 总统	ガ `参
布 总	ガ `
布 做	ガ 暗
步 出	B X
步 发展	B oi
步 奋斗	B 灸矮
步 扑上去	B 汲Wh
步 扑	B 汲
步 之外	B ぇ~
部 颁发	场 {o
部 采访	场 蹦X
部 采取	场 蹦
部 出口	场 Xf
部 出身	场 Xō
部 出现	场 X{
部 出血	场 X
部 倒塌	场 硕
部 发表声明	场 o砹n
部 发表	场 o
部 发布	场 oガ
部 发出	场 oX
部 发动	场 o笆
部 发行	场 o
部 发言人	场 oēH
部 发	场 o
部 公布	场 そガ
部 共产主义	场 @玻Dq
部 共	场 @
部 技术	场 мN
部 开发	场 }o
部 戚	场 杯
部 手术	场 もN
部 提出	场 矗X
部 推出	场 崩X
部 宪法草案	场 舅k螽
部 宣布	场 钮
部 医疗	场 洛励
部 艺术	场 美N
部 印发	场 Lo
部 预测	场 w代
部 战况	场 驹p
部 指出	场 X
部 专家	场 Ma
部 专门	场 M
部 总工程师	场 `u{v
部 作出	场 @X
猜 共	q @
猜 提出	q 矗X
材 测试	 代刚
材 出口	 Xf
材 丰	 伦
材 股份有限公司	 靴鳓抄そq
材 价格	 基
材 树	 攫
材 有限公司	 Τそq
才 背	~ I
才 并	~ }
才 出身	~ Xō
才 出土	~ Xg
才 出现	~ X{
才 发觉	~ o谋
才 发现	~ o{
才 发	~ o
才 回家	~ ^a
才 家	~ a
才 开发	~ }o
才 能够	~ 喟
才 提出	~ 矗X
才 宣布	~ 钮
才 意识	~ N醚
才 有希望	~ Τ票
才 有资格	~ Τ戈
才 找出	~ тX
财 发	] o
采 办	蹦 快
采 备	蹦 称
采 表演	蹦 砗t
采 场面	蹦 初
采 出	蹦 X
采 储	蹦 x
采 的	蹦 
采 栋	蹦 瓷
采 队	蹦 钉
采 对局	蹦 癸Ы
采 恩	蹦 
采 伐	蹦 ワ
采 飞扬	蹦 复
采 风	蹦 
采 夫	蹦 ひ
采 富	蹦 I
采 古	蹦 j
采 和	蹦 M
采 后生	蹦 幞
采 回	蹦 ^
采 机械	蹦 诀瘪
采 节目	蹦 `ヘ
采 金	蹦 
采 进行	蹦 i
采 进	蹦 i
采 精华	蹦 弘地
采 举行	蹦 |
采 空	蹦 
采 滥	蹦 垒
采 两	蹦 ㄢ
采 烈	蹦 P
采 率	蹦 v
采 罗	蹦 霉
采 买	蹦 R
采 煤矿	蹦 费q
采 煤	蹦 费
采 蜜	蹦 e
采 暖	蹦 x
采 平台	蹦 キx
采 七	蹦 C
采 区	蹦 跋
采 三	蹦 T
采 森林	蹦 此L
采 声	蹦 n
采 石	蹦 ホ
采 收	蹦 Μ
采 四	蹦 |
采 穗	蹦 J
采 所	蹦 ┮
采 塔	蹦 娥
采 挖	蹦 
采 完了	蹦 ЧF
采 为	蹦 
采 文化	蹦 ゅて
采 写作	蹦 g@
采 写	蹦 g
采 选	蹦 匡
采 盐	蹦 Q
采 样	蹦 妓
采 药材	蹦 媚
采 冶	蹦 M
采 由	蹦 パ
采 油船	蹦 o差
采 油	蹦 o
采 育	蹦 |
采 原煤	蹦 旆
采 运	蹦 B
采 照	蹦 酚
采 珍	蹦 
采 中外	蹦 い~
采 种	蹦 贺
采 资源	蹦 戈方
采 拮	蹦 
采 撷	蹦 ^
彩 浓妆	m @З
彩 之外	m ぇ~
菜 价格	垫 基
菜 十万	垫 QU
蔡 家	讲 a
蔡 伦	讲 
残 匪	摧 
残 迹	摧 格
残 舍	摧 
苍 树	a 攫
仓 焊接	 k钡
藏 布	旅 ガ
藏 丰	旅 伦
藏 极为	旅 伐
藏 开采	旅 }蹦
藏 石匠	旅 ホK
操 持家	巨 a
曹 树	变 攫
曹 婉	变 胞
草 发展	 oi
草 方格	 よ
草 库伦	 w
草 签	 帽
草 舍	 
草 种树	 贺攫
策 出力	郸 XO
策 伦	郸 
侧 扑	凹 汲
册 发	U o
册 共	U @
测 出	代 X
测 技术	代 мN
测 中心站	代 いみ
层 出现	h X{
层 发酵	h o幻
层 发展	h oi
层 共产党	h @玻囊
层 共	h @
层 技术人员	h мNH
层 坚实	h 绊龟
层 开发	h }o
层 楼房	h 加┬
层 默默无闻	h qqLD
层 权力斗争	h vO矮
层 塌陷	h 厄炒
层 涂料	h 额
层 作出	h @X
茶 开发	 }o
查 布	d ガ
查 当年	d 讽~
查 发展	d oi
查 合格	d X
察 布	诡 ガ
察 技术	诡 мN
差 出现	t X{
差 共	t @
铲 边	藐 娩
铲 铲	藐 藐
铲 除	藐 埃
铲 掉	藐 奔
铲 砌砖	藐 淇j
铲 去	藐 h
铲 土	藐 g
铲 我	藐 и
铲 雪	藐 撤
产 板栗	玻 O
产 出	玻 X
产 当年	玻 讽~
产 发电机	玻 oq诀
产 发电	玻 oq
产 发挥	玻 o揣
产 丰	玻 伦
产 果树	玻 G攫
产 技术经验	玻 мNg喷
产 技术	玻 мN
产 降生	玻 哎
产 进出口	玻 iXf
产 开发	玻 }o
产 千万	玻 dU
产 万	玻 U
产 限额	玻 B
产 预测	玻 w代
昌 出席	 Xu
昌 坚持	 绊
昌 提出	 矗X
昌 指出	 X
场 爆发	初 zo
场 斗争	初 矮
场 发挥	初 o揣
场 发展	初 oi
场 丰	初 伦
场 扶	初 н
场 共鸣	初 @伙
场 漫	初 憨
场 盛况空前	初 脖p奴e
场 万	初 U
场 演出	初 tX
场 义演	初 qt
场 映出	初 MX
场 战斗	初 驹矮
常 农家	` Aa
常 状况	` p
长 采访	 蹦X
长 出发	 Xo
长 出席	 Xu
长 出	 X
长 堤	 出
长 发挥	 o揣
长 发现	 o{
长 发展	 oi
长 发	 o
长 丰	 伦
长 葫芦	 脯莫
长 极为	 伐
长 技术	 мN
长 阶段	 顶q
长 敬	 q
长 提出	 矗X
长 万	 U
长 邢	 ǚ
长 足迹	 ì格
长 作出	 @X
偿 出让	v X琵
偿 技术	v мN
偿 有限	v Τ
厂 板	t O
厂 薄板	t 痢O
厂 采取	t 蹦
厂 采用	t 蹦ノ
厂 采	t 蹦
厂 出口	t Xf
厂 出力	t XO
厂 出现	t X{
厂 当年	t 讽~
厂 发出	t oX
厂 发动	t o笆
厂 发起	t o_
厂 发生	t oネ
厂 发展	t oi
厂 共生	t @ネ
厂 共同	t @P
厂 共有	t @Τ
厂 共	t @
厂 汲	t V
厂 技术	t мN
厂 家	t a
厂 价格	t 基
厂 坚持不懈	t 绊ぃ居
厂 坚持	t 绊
厂 开发	t }o
厂 老板	t ρO
厂 拿出	t 偿X
厂 签	t 帽
厂 提出	t 矗X
厂 突出	t 馥X
厂 推出	t 崩X
厂 星罗棋布	t P霉囱ガ
厂 严格	t Y
厂 医疗	t 洛励
厂 针布	t wガ
厂 专门	t M
畅 出现	Z X{
畅 引发	Z まo
畅 状况	Z p
唱 出	佰 X
唱 共产党	佰 @玻囊
超 百万	W κU
超 定额	W wB
超 丰	W 伦
超 共	W @
超 厚板	W pO
超 千万	W dU
超 苏联	W 默p
超 写文章	W gゅ彻
朝 公布	绰 そガ
朝 签	绰 帽
朝 苏	绰 默
潮 抹布	奸 ┵ガ
车 出发	ó Xo
车 出来	ó Xㄓ
车 共	ó @
车 技术	ó мN
车 况	ó p
扯 布	ц ガ
撤 并	M }
臣 出席	 Xu
尘 技术	剐 мN
陈 发	朝 o
陈 丰	朝 伦
陈 家	朝 a
陈 坚	朝 绊
陈 佩	朝 ㄘ
陈 启发	朝 币o
陈 树	朝 攫
陈 苏	朝 默
陈 婉	朝 胞
衬 布	浓 ガ
称 喇嘛教	嘿 斥估毙
称 苏	嘿 默
称 西藏	嘿 杪
称 义演	嘿 qt
城 矮小	 Gp
城 采访	 蹦X
城 出版社	 X┆
城 出现	 X{
城 发生	 oネ
城 格	 
城 家政学	 aF厩
城 开发	 }o
城 漫	 憨
城 派出所	 ％X┮
城 千万	 dU
城 签	 帽
城 苏州	 默{
城 万	 U
城 宣布	 钮
城 有线电视	 Τuq跌
城 妆	 З
成 百万富翁	Θ κUI
成 并	Θ }
成 额外	Θ B~
成 额	Θ B
成 发电	Θ oq
成 发疯	Θ o浩
成 家	Θ a
成 坚	Θ 绊
成 漫画	Θ 憨e
成 树苗	Θ 攫]
成 图板	Θ 瓜O
成 有限责任	Θ Τdヴ
成 治疗	Θ v励
成 主席	Θ Du
呈 发展	e oi
呈 巨额	e エB
呈 明显	e 陪
呈 现出	e {X
乘 出租	 X
乘 公共汽车	 そ@Tó
乘 摩托车	 集Λó
程 背道而驰	{ IDτ梗
程 并	{ }
程 采取	{ 蹦
程 发挥	{ o揣
程 共	{ @
程 家	{ a
程 能够	{ 喟
程 情况	{ 薄p
程 万	{ U
程 作出	{ @X
澄 澄	坚 坚
澄 的	坚 
澄 还	坚 临
澄 今天	坚 さぱ
澄 庆	坚 y
澄 司长	坚 q
澄 渝	坚 袋
澄 在	坚 b
承 发包	┯ o]
承 佩	┯ ㄘ
吃 出	Y X
吃 国家	Y 瓣a
吃 家常	Y a`
吃 自家	Y 郛a
痴 劲	扶 l
痴 情	扶 薄
痴 如	扶 p
痴 心	扶 み
持 坚	 绊
持 乒乓球	 モャy
迟 撤出	筐 MX
迟 发射	筐 og
迟 婚	筐 B
冲 出路	R X隔
冲 出门	R X
冲 出	R X
冲 塌	R 厄
虫 出售	 X扳
虫 学术界	 厩N
崇 伦	R 
崇 托	R Λ
抽 签	┾ 帽
酬 技术	S мN
愁 丰	T 伦
筹 巨额	w エB
绸 缎	瑚 v
臭 皮匠	 ブK
初 发	 o
初 宣布	 钮
出 艾	X 
出 爱	X R
出 安排	X w逼
出 安全	X w
出 扒	X ザ
出 白	X フ
出 百	X κ
出 班	X Z
出 板球	X Oy
出 半月	X bる
出 半	X b
出 包括	X ]A
出 薄板	X 痢O
出 保温瓶	X O放~
出 保险柜	X OId
出 宝贵	X _Q
出 报告	X 厨i
出 报纸	X 厨
出 爆裂	X z吊
出 爆炸	X z
出 被	X Q
出 本地	X セa
出 笨	X 猜
出 比	X ゑ
出 必要	X ゲn
出 便	X K
出 变动	X 跑笆
出 表决	X 悫M
出 冰	X B
出 并	X }
出 博士	X 痴h
出 勃	X k
出 补	X 干
出 不同	X ぃP
出 不	X ぃ
出 布面	X ガ
出 部署	X 场p
出 材料	X 鳟
出 材	X 
出 财富	X ]I
出 参加	X 把[
出 参	X 把
出 叉	X e
出 铲	X 藐
出 产量	X 玻q
出 产品	X 玻~
出 长	X 
出 厂	X t
出 朝	X 绰
出 车辆	X ó进
出 车	X ó
出 城	X 
出 成功	X Θ\
出 成	X Θ
出 乘	X 
出 承前启后	X ┯e币
出 充满	X R骸
出 初步	X 歙B
出 厨房	X p┬
出 处理	X Bz
出 川	X t
出 传	X 肚
出 窗口	X 怠f
出 春季	X Ku
出 纯	X 
出 此时	X 巩
出 此	X 
出 从未	X qゼ
出 从	X q
出 达到	X F
出 打通	X ゴq
出 大豆	X jě
出 大力	X jO
出 大量	X jq
出 大陆	X j嘲
出 大型	X j
出 大约	X j
出 大	X j
出 带	X a
出 代表	X N
出 单	X 虫
出 淡淡	X HH
出 当今	X 讽さ
出 当日	X 讽ら
出 当时	X 讽
出 党	X 囊
出 岛	X q
出 道路	X D隔
出 得分	X oだ
出 得	X o
出 的	X 
出 灯	X O
出 等	X 单
出 低	X C
出 敌人	X 寄H
出 地质	X a借
出 第三	X 材T
出 第一	X 材@
出 点子	X Il
出 点	X I
出 电冰箱	X qBc
出 电工	X qu
出 电话	X q杠
出 调查	X 秸d
出 调	X 秸
出 定	X w
出 订	X q
出 东西	X F
出 冬	X V
出 洞	X }
出 豆腐	X ěG
出 独立	X Wミ
出 队伍	X 钉ヮ
出 对局	X 癸Ы
出 对数	X 癸计
出 对	X 癸
出 蹲	X 蜜
出 多少	X hぶ
出 多种	X h贺
出 多	X h
出 朵	X Ψ
出 二十	X GQ
出 发票	X o布
出 反映	X はM
出 方向	X よV
出 防守	X 睛u
出 仿	X ラ
出 访	X X
出 纺织	X 悸
出 非法	X Dk
出 非凡	X DZ
出 非洲	X Dw
出 飞	X 
出 废墟	X oV
出 废	X o
出 分配	X だt
出 粉红色	X 滑酽
出 粉	X 
出 丰	X 伦
出 符合	X 才X
出 服装	X A杆
出 福音	X 褐
出 负责	X td
出 干部	X F场
出 高度	X 蔼
出 高级	X 蔼
出 高速	X 蔼t
出 高	X 蔼
出 格	X 
出 个人	X 婴H
出 个	X 
出 各类	X U摸
出 各种	X U贺
出 各	X U
出 耕地	X 薛a
出 更加	X 螗[
出 更	X 
出 工程	X u{
出 工艺	X u美
出 工作	X u@
出 工	X u
出 供	X ㄑ
出 公路	X そ隔
出 贡献	X ^m
出 共	X @
出 估价	X 艋
出 股票	X 巡
出 故障	X G毁
出 固定资产	X Tw戈玻
出 关键	X 闽龄
出 关	X 闽
出 官兵	X xL
出 冠军	X ax
出 管理	X 恨z
出 光	X 
出 规定	X Ww
出 规划	X W购
出 贵阳	X Q锭
出 贵重	X Q
出 锅	X 羚
出 国际	X 瓣悔
出 国家	X 瓣a
出 国界	X 瓣
出 国内	X 瓣ず
出 过分	X Lだ
出 过去	X Lh
出 过重	X L
出 过	X L
出 海口	X f
出 汉城	X ~
出 好	X n
出 和平	X Mキ
出 和	X M
出 合格	X X
出 合葬	X X府
出 很	X 
出 狠	X 
出 洪	X x
出 红灯	X 蹩O
出 红	X 
出 后	X 
出 化	X て
出 话	X 杠
出 欢	X w
出 环境	X 吏挂
出 缓	X w
出 黄金	X 独
出 黄	X 独
出 回	X ^
出 汇票	X 蹲布
出 浑身解数	X 待ō秆计
出 或	X ┪
出 击	X 阑
出 机构	X 诀c
出 积极	X n伐
出 激动	X E笆
出 缉	X r
出 吉	X N
出 极	X 伐
出 几分	X Xだ
出 几	X X
出 技术人员	X мNH
出 技术	X мN
出 记者	X O
出 既	X J
出 继	X ~
出 家门	X a
出 价值	X 基
出 监狱	X 菏夯
出 坚	X 绊
出 尖	X y
出 检验	X 浪喷
出 简	X 虏
出 减免	X 搭K
出 减	X 搭
出 健将	X 胺N
出 建立	X 廿
出 建设	X 爻]
出 将	X N
出 江	X 
出 疆	X 忙
出 奖金	X 贱
出 交	X ユ
出 角	X à
出 绞	X 当
出 教练	X 毙m
出 教师	X 毙v
出 较	X 耕
出 接近	X 钡
出 接	X 钡
出 杰出	X 城X
出 捷报	X 倍厨
出 结论	X 挡阶
出 解决	X 秆M
出 界	X 
出 金银	X 骰
出 今年	X さ~
出 进	X i
出 近年	X 瘭~
出 近期	X 翊
出 近	X 
出 尽可能	X 荷i
出 惊天动地	X 佩ぱ笆a
出 精神病	X 弘f
出 精心	X 弘み
出 精	X 弘
出 经费	X gO
出 经过	X gL
出 经济	X g蕾
出 经验	X g喷
出 井	X か
出 九十	X EQ
出 酒	X s
出 救灾	X 毕a
出 聚	X E
出 巨大	X エj
出 巨款	X エ蹿
出 具体	X ㄣ砰
出 具有	X ㄣΤ
出 具	X ㄣ
出 决策	X M郸
出 决定	X Mw
出 军民	X xチ
出 军人	X xH
出 军事	X xㄆ
出 开普敦	X }炊窗
出 开	X }
出 刊物	X Z
出 刊	X Z
出 抗	X к
出 考察	X σ诡
出 科技	X 歆
出 科	X 
出 壳	X 催
出 可观	X i[
出 可口	X if
出 可	X i
出 克制	X J
出 库	X w
出 块	X 遏
出 困境	X x挂
出 扩大	X Xj
出 扩	X X
出 垃圾	X UВ
出 蜡染	X 您V
出 栏	X 逆
出 劳力	X 骋O
出 劳务	X 骋叭
出 劳	X 骋
出 老人	X ρH
出 老	X ρ
出 雷鸣	X p伙
出 累累	X 仓仓
出 类似	X 摸
出 理智	X z醇
出 历史	X 菌v
出 力所能及	X O┮啶
出 联合	X pX
出 粮食	X 鲁
出 良	X }
出 两	X ㄢ
出 量	X q
出 了	X F
出 灵活	X F
出 岭	X 拉
出 另	X t
出 令人	X OH
出 硫	X 哺
出 卢	X c
出 旅客	X 全
出 率	X v
出 马皮	X 皑ブ
出 马	X 皑
出 满意	X 骸N
出 满园春色	X 骸堕K
出 满	X 骸
出 毛笔	X を掸
出 煤	X 费
出 美丽	X R
出 美元	X じ
出 蒙古	X Xj
出 米	X μ
出 面积	X 笨n
出 苗	X ]
出 民俗学	X チU厩
出 民	X チ
出 明确	X T
出 明显	X 陪
出 明	X 
出 名片	X W
出 名字	X Wr
出 魔	X ]
出 谋划	X 垦购
出 谋	X 垦
出 某些	X Yㄇ
出 亩	X a
出 木料	X れ
出 目前	X ヘe
出 那	X ê
出 耐热	X @荐
出 南极	X n伐
出 男女	X kk
出 男子	X kl
出 男	X k
出 难得	X 螟o
出 难闻	X 螟D
出 呢	X O
出 能够	X 喟
出 能	X 
出 你	X A
出 年轻	X ~淮
出 牛黄	X 独
出 浓厚	X @p
出 农业	X A~
出 农	X A
出 努力	X VO
出 女性	X k┦
出 女子	X kl
出 女	X k
出 排	X 逼
出 牌子	X Pl
出 盘	X L
出 跑道	X ]D
出 蓬勃	X 酱k
出 贫困	X hx
出 迫切	X ち
出 圃	X E
出 期间	X 戳丁
出 七	X C
出 其	X ㄤ
出 齐	X 霍
出 起	X _
出 企业	X ~
出 汽油	X To
出 千万	X dU
出 千	X d
出 前所未有	X e┮ゼΤ
出 前	X e
出 墙	X 鲤
出 强大	X jj
出 强烈	X jP
出 抢	X m
出 鞘	X T
出 切合	X ちX
出 切实	X ち龟
出 亲	X 克
出 青	X C
出 情	X 薄
出 求	X D
出 圈	X 伴
出 全部	X 场
出 全国	X 瓣
出 全	X 
出 拳头	X 崩Y
出 群众	X s渤
出 让步	X 琵B
出 人才	X H~
出 人工	X Hu
出 人力	X HO
出 人员	X H
出 人	X H
出 任何	X ヴ
出 任	X ヴ
出 日本	X らセ
出 日记	X らO
出 肉	X ψ
出 如此	X p
出 入境手续	X J挂も尿
出 塞	X 峨
出 三	X T
出 色彩	X 獗m
出 杀	X 炳
出 沙漠	X Fz
出 山峰	X sp
出 山	X s
出 商品	X 坝~
出 上策	X W郸
出 上海	X W
出 上级	X W
出 上升	X Wど
出 上述	X Wz
出 上	X W
出 少数民族	X ぶ计チ壁
出 社会主义	X 婪|Dq
出 设计	X ]p
出 沈	X H
出 生命	X ネR
出 省	X 
出 胜负	X 秤t
出 师	X v
出 十足	X Qì
出 十	X Q
出 时代	X 丧N
出 时间	X 啥
出 时	X 
出 实践	X 龟筋
出 实力	X 龟O
出 实效	X 龟
出 世界	X @
出 事故	X ㄆG
出 是否	X O_
出 适合	X AX
出 适	X A
出 市场	X カ初
出 市政府	X カF┎
出 室外	X 钎~
出 收据	X Μ沮
出 手	X も
出 书法	X 血k
出 书	X 
出 数	X 计
出 水槽	X 艏
出 水稻	X 艚_
出 水果	X 舄G
出 水	X 
出 税款	X |蹿
出 说明	X 弧
出 说	X 弧
出 硕	X 河
出 撕	X 脊
出 思想	X 浞Q
出 四	X |
出 饲	X }
出 所	X ┮
出 他们	X L
出 他	X L
出 它的	X ウ
出 它	X ウ
出 台	X x
出 摊	X u
出 特色	X S
出 天津	X ぱz
出 填补	X 恶干
出 条	X 兵
出 铁路	X K隔
出 铁	X K
出 通讯	X qT
出 铜	X 簧
出 痛苦	X hW
出 突出	X 馥X
出 图案	X 瓜
出 图片	X 瓜
出 图书	X 瓜
出 兔	X ㄟ
出 弯道	X sD
出 完全	X Ч
出 完整	X Ч俱
出 旺盛	X 舨
出 微妙	X LМ
出 微弱	X Lz
出 危	X M
出 违	X H
出 唯一	X 斑@
出 为	X 
出 维持	X 蝴
出 维	X 蝴
出 文具	X ゅㄣ
出 稳定	X 铆w
出 我们	X и
出 我	X и
出 屋外	X 违~
出 无机	X L诀
出 无数	X L计
出 无	X L
出 武器	X Z竟
出 武装人员	X Z杆H
出 五	X き
出 物价	X 基
出 物	X 
出 务实	X 叭龟
出 西藏	X 杪
出 息	X 
出 喜讯	X 尺T
出 喜	X 尺
出 系列	X tC
出 戏	X 栏
出 细	X 灿
出 下	X U
出 夏	X L
出 显著	X 陪帝
出 险	X I
出 现款	X {蹿
出 现象	X {H
出 县	X 郡
出 限期	X 戳
出 线	X u
出 相当	X 鄯
出 相应	X 劾
出 相	X 
出 祥	X 不
出 向	X V
出 销售	X P扳
出 消防车	X 鲸
出 消息	X 
出 小组	X p舱
出 小	X p
出 校园	X 斩
出 效	X 
出 鞋垫	X c乖
出 协调	X 蠼
出 欣慰	X Y饥
出 新闻	X sD
出 新型	X s
出 新	X s
出 心脏	X み纽
出 星星	X PP
出 形	X 
出 行	X 
出 性能	X ┦
出 许多	X \h
出 许	X \
出 叙利亚	X 痹Qㄈ
出 悬	X a
出 压花	X 溃
出 亚洲	X ㄈw
出 岩	X ━
出 眼底	X 泊┏
出 演出	X tX
出 阳	X 锭
出 样品	X 妓~
出 样子	X 妓l
出 样	X 妓
出 要	X n
出 一点	X @I
出 一连串	X @s
出 一流	X @y
出 一身	X @ō
出 一系列	X @tC
出 一些	X @ㄇ
出 一整	X @俱
出 一	X @
出 医生	X 洛ネ
出 医院	X 洛|
出 遗传工程	X 框肚u{
出 以下	X HU
出 意外	X N~
出 义务	X q叭
出 印	X L
出 英国	X ^瓣
出 应	X 莱
出 营救	X 犁毕
出 迎	X 
出 用	X ノ
出 优秀	X uq
出 优	X u
出 悠扬	X y喘
出 由	X パ
出 油	X o
出 有关	X Τ闽
出 有利	X ΤQ
出 有效	X Τ
出 有	X Τ
出 友好代表团	X ねnN砉
出 淤泥	X Jd
出 于	X _
出 渔船	X 寒差
出 与	X P
出 语	X y
出 玉米	X ドμ
出 狱	X 夯
出 豫剧	X 枯@
出 原因	X 歃]
出 院	X |
出 约	X 
出 越来越	X VㄓV
出 钥匙	X _巴
出 运动员	X B笆
出 运	X B
出 在	X b
出 早操	X Ν巨
出 增长	X W
出 渣	X 错
出 展	X i
出 战斗	X 驹矮
出 战争	X 驹
出 战	X 驹
出 站	X 
出 账	X 姐
出 沼气	X h
出 这	X o
出 诊断	X E_
出 阵营	X }犁
出 阵阵	X }}
出 蒸蒸日上	X ]]らW
出 征	X ┖
出 正常	X タ`
出 正在	X タb
出 政权	X Fv
出 政治	X Fv
出 之	X ぇ
出 值班	X 券Z
出 指标	X 夹
出 指	X 
出 质量	X 借q
出 治疗	X v励
出 中国大陆	X い瓣j嘲
出 中国人	X い瓣H
出 中国	X い瓣
出 中华	X い地
出 中医	X い洛
出 中	X い
出 重大	X j
出 重围	X 瞅
出 重要	X n
出 众人	X 渤H
出 蛛丝	X 碉捣
出 瞩目	X fヘ
出 主权	X Dv
出 主要	X Dn
出 专栏	X M逆
出 专人	X MH
出 专用	X Mノ
出 专	X M
出 砖	X j
出 卓著	X 舻
出 茁壮	X _Ё
出 资金	X 戈
出 资源	X 戈方
出 资	X 戈
出 滋润	X 逮柬
出 自己	X 郅v
出 总体	X `砰
出 总统府	X `参┎
出 最好	X 程n
出 最后	X 程
出 最佳	X 程ㄎ
出 最	X 程
出 作品	X @~
出 作用	X @ノ
出 拚	X ╅
出 殡	X l
锄 种树	S 贺攫
除 发电	埃 oq
除 公共汽车	埃 そ@Tó
除 国家	埃 瓣a
除 化妆品	埃 てЗ~
除 家	埃 a
除 佩	埃 ㄘ
除 乒乓球	埃 モャy
除 特殊	埃 S
除 西藏	埃 杪
处 并	B }
处 发表	B o
处 发出	B oX
处 发	B o
处 公布	B そガ
处 共	B @
处 国家	B 瓣a
处 价格	B 基
处 敬	B q
处 救出	B 毕X
处 签	B 帽
处 情况	B 薄p
处 树立	B 攫ミ
处 苏联	B 默p
处 宿舍	B J
处 提出	B 矗X
处 违法	B Hk
处 违反	B Hは
处 邢	B ǚ
处 遗迹	B 框格
处 预测	B w代
川 报名	t 厨W
川 并	t }
川 出席	t Xu
川 日出	t らX
穿 灯笼裤	 O泞壳
传 布	肚 ガ
传 出来	肚 Xㄓ
传 出去	肚 Xh
传 出	肚 X
传 技术	肚 мN
传 万	肚 U
船 发生	差 oネ
串 车灯	 óO
串 成	 Θ
串 串	 
串 村	 
串 大家	 ja
串 到	 
串 的	 
串 调	 秸
串 岗	 ^
串 合在一起	 Xb@_
串 红绿灯	 鹾窨O
串 户	 め
串 换	 传
串 讲	 量
串 精彩	 弘m
串 了	 F
串 令人	 OH
串 门	 
串 亲	 克
串 闪光	 {
串 深深	 ``
串 深	 `
串 糖葫芦	 }脯莫
串 糖球	 }y
串 外国	 ~瓣
串 威	 
串 问题	 拜D
串 西	 
串 巷	 
串 学	 厩
串 羊肉	 οψ
串 洋	 v
串 有关	 Τ闽
串 友	 ね
串 玉米	 ドμ
串 钥匙	 _巴
串 寨	 闺
串 中华	 い地
串 助人为乐	 UH凹
窗 采用	怠 蹦ノ
幢 宿舍	l J
床 技术	 мN
床 价格	 基
创 百万	承 κU
创 出国	承 X瓣
创 出口	承 Xf
创 出来	承 Xㄓ
创 出	承 X
创 国家	承 瓣a
春 并	K }
春 提出	K 矗X
椿 树	菹 攫
纯 棉布	 粗ガ
茨 指出	 X
磁 技术	合 мN
磁 疗	合 励
辞 杯	勉 M
慈 溪	O 匪
瓷 杯	病 M
瓷 技术	病 мN
瓷 艺术	病 美N
瓷 专家	病 Ma
词 并	迭 }
词 出版	迭 X
词 发表	迭 o
词 指出	迭 X
词 作家	迭 @a
此 并	 }
此 采取	 蹦
此 发表	 o
此 发出	 oX
此 发现	 o{
此 发展	 oi
此 公布	 そガ
此 极为	 伐
此 启发	 币o
此 殊荣	 砗a
此 提出	 矗X
此 作出	 @X
刺 阶段	 顶q
次 搬家	Ω ha
次 爆发	Ω zo
次 杯	Ω M
次 驳倒	Ω 婚
次 采访	Ω 蹦X
次 采矿	Ω 蹦q
次 采	Ω 蹦
次 测试	Ω 代刚
次 出动	Ω X笆
次 出国	Ω X瓣
次 出口	Ω Xf
次 出没	Ω XS
次 出入	Ω XJ
次 出色	Ω X
次 出席	Ω Xu
次 出现	Ω X{
次 出	Ω X
次 大家	Ω ja
次 发表	Ω o
次 发布	Ω oガ
次 发出	Ω oX
次 发放	Ω o
次 发起	Ω o_
次 发射	Ω og
次 发生	Ω oネ
次 发现	Ω o{
次 发	Ω o
次 丰	Ω 伦
次 格	Ω 
次 公布	Ω そガ
次 公共汽车	Ω そ@Tó
次 共产党	Ω @玻囊
次 共计	Ω @p
次 共	Ω @
次 国家元首	Ω 瓣aじ
次 合格	Ω X
次 回家	Ω ^a
次 家长	Ω a
次 家	Ω a
次 开发	Ω }o
次 拿出	Ω 偿X
次 扑灭	Ω 汲防
次 企业家	Ω ~a
次 签署	Ω 帽p
次 签约	Ω 帽
次 手术	Ω もN
次 苏联	Ω 默p
次 塌方	Ω 厄よ
次 特殊	Ω S
次 提出	Ω 矗X
次 体验	Ω 砰喷
次 挑战	Ω D驹
次 推出	Ω 崩X
次 外出	Ω ~X
次 违反	Ω Hは
次 选出	Ω 匡X
次 学术	Ω 厩N
次 演出	Ω tX
次 义演	Ω qt
次 遭受	Ω D
次 战斗	Ω 驹矮
次 政治体制	Ω Fv砰
次 植树	Ω 从攫
次 指出	Ω X
次 治疗	Ω v励
次 主席团	Ω Du刮
次 专家	Ω Ma
次 专门	Ω M
次 走出	Ω ǐX
从 阿根廷	q 讧
从 巴格达	q ぺ婀F
从 背后	q I
从 布	q ガ
从 城市	q 哎
从 出版	q X
从 出入	q XJ
从 出生	q Xネ
从 出	q X
从 当年	q 讽~
从 顶峰	q 郴p
从 发布	q oガ
从 发达	q oF
从 发动机	q o笆诀
从 发酵	q o幻
从 发展	q oi
从 奋斗	q 灸矮
从 丰	q 伦
从 扶	q н
从 哥伦比亚	q 舡郅瘿
从 格	q 
从 共产党员	q @玻囊
从 共产党	q @玻囊
从 国家	q 瓣a
从 激发	q Eo
从 技术	q мN
从 家庭	q ax
从 家用	q aノ
从 家	q a
从 坚持	q 绊
从 江苏	q 磕
从 降生	q 哎
从 局部	q Ы场
从 开发	q }o
从 考场	q σ初
从 老家	q ρa
从 伦敦	q 鄞
从 美术	q N
从 民族学	q チ壁厩
从 派出所	q ％X┮
从 乒乓	q モャ
从 塞浦路斯	q 峨隔吹
从 苏联	q 默p
从 苏伊士运河	q 默レhBe
从 苏州	q 默{
从 苏	q 默
从 特殊	q S
从 提出	q 矗X
从 文章	q ゅ彻
从 西藏	q 杪
从 现阶段	q {顶q
从 药物治疗	q 媚v励
从 意识	q N醚
从 有限	q Τ
从 战场	q 驹初
从 植树	q 从攫
从 中华人民共和国	q い地Hチ@M瓣
从 专家	q Ma
丛 黄海	O 独
粗 树	彩 攫
脆 出	 X
脆 发硬	 ow
脆 走出	 ǐX
村 扁	 
村 并	 }
村 采访	 蹦X
村 串	 
村 发生	 oネ
村 发现	 o{
村 发展	 oi
村 共同	 @P
村 共有	 @Τ
村 共	 @
村 火力发电厂	 酩Ooqt
村 楼房	 加┬
村 罗布	 霉ガ
村 瀑布	 rガ
村 签	 帽
村 演出	 tX
存 共同	s @P
存 伦	s 
撮 煤灰	技 费η
达 百万	F κU
达 杯	F M
达 布	F ガ
达 发生	F oネ
达 发	F o
达 技术	F мN
达 伦	F 
达 万	F U
达 指出	F X
打 发	ゴ o
打 国家	ゴ 瓣a
打 扑克	ゴ 汲J
打 万花	ゴ U
打 印出	ゴ LX
打 竹板	ゴ λO
打 资格	ゴ 戈
大 板	j O
大 爆发	j zo
大 背景	j I春
大 铲	j 藐
大 城市	j 哎
大 出版社	j X┆
大 出版	j X
大 出风头	j X防Y
大 出口	j Xf
大 出血	j X
大 出	j X
大 堤	j 出
大 额	j B
大 发横财	j o绢]
大 发挥	j o揣
大 发明	j o
大 发展	j oi
大 发	j o
大 法家	j ka
大 丰	j 伦
大 格局	j 妲
大 共有	j @Τ
大 规格	j W
大 国家	j 瓣a
大 葫芦	j 脯莫
大 画家	j ea
大 技术	j мN
大 家庭	j ax
大 家业	j a~
大 家用	j aノ
大 家族	j a壁
大 坚持	j 绊
大 江苏	j 磕
大 降雨	j 矮B
大 阶段	j 顶q
大 杰出	j 城X
大 进出口	j iXf
大 酒家	j sa
大 开发	j }o
大 课题	j 揭D
大 库伦	j w
大 老板	j ρO
大 美术	j N
大 乒乓球	j モャy
大 启发	j 币o
大 情况	j 薄p
大 秋	j 
大 三弦	j T┒
大 手术前	j もNe
大 手术	j もN
大 树	j 攫
大 数额	j 计B
大 水土保持	j 簸gO
大 塌方	j 厄よ
大 踏步走	j 今Bǐ
大 踏步	j 今B
大 提出	j 矗X
大 挑战	j D驹
大 突出	j 馥X
大 文章	j ゅ彻
大 有希望	j Τ票
大 榆树	j 樊攫
大 指出	j X
大 主席	j Du
大 专门委员会	j Me|
大 专门	j M
大 做文章	j 暗ゅ彻
大 作家	j @a
傣 家人	V aH
戴 安全帽	拦 wU
戴 格	拦 
戴 家	拦 a
戴 帽子	拦 Ul
戴 帽	拦 U
带 背包	a I]
带 并	a }
带 出来	a Xㄓ
带 出	a X
带 发生	a oネ
带 发行	a o
带 发展	a oi
带 技术	a мN
带 嫁妆	a 儿З
带 实行宵禁	a 龟娈dT
带 之外	a ぇ~
代 采购	N 蹦潦
代 痴	N 扶
代 登山家	N nsa
代 发工资	N ou戈
代 发	N o
代 歌唱家	N q佰a
代 革命家	N 博Ra
代 画家	N ea
代 技术	N мN
代 杰出	N 城X
代 企业家	N ~a
代 签名	N 帽W
代 签	N 帽
代 提出	N 矗X
代 五光十色	N きQ
代 主席	N Du
代 作曲家	N @Ρa
贷 斗	U 矮
贷 发放	U o
贷 扶	U н
待 出门	 X
待 合格	 X
待 开发	 }o
待 找出	 тX
丹 治疗	う v励
单 板	虫 O
单 家	虫 a
单 弦	虫 ┒
但 并	 }
但 布	 ガ
但 城市	 哎
但 出口	 Xf
但 出现	 X{
但 出	 X
但 大家	 ja
但 当年	 讽~
但 到场	 斐
但 发愁	 oT
但 发生	 oネ
但 发送	 oe
但 发展	 oi
但 分析家	 だRa
但 风格	 樊
但 格	 
但 公报	 そ厨
但 共产党	 @玻囊
但 共	 @
但 规格	 W
但 国家	 瓣a
但 技术	 мN
但 家家	 aa
但 家	 a
但 坚持	 绊
但 坚决	 绊M
但 开发	 }o
但 树立	 攫ミ
但 树苗	 攫]
但 数额	 计B
但 苏联	 默p
但 苏	 默
但 西藏	 杪
淡 价格	H 基
弹 出	u X
当 百万富翁	讽 κUI
当 大家	讽 ja
当 发现	讽 o{
当 国家	讽 瓣a
当 合格	讽 X
当 技术	讽 мN
当 喇嘛	讽 斥估
当 妈妈	讽 洱洱
当 美术	讽 N
当 书法家	讽 血ka
当 苏联	讽 默p
当 苏醒	讽 默眶
当 西藏	讽 杪
当 宣布	讽 钮
当 专家	讽 Ma
党 采取	囊 蹦
党 代理主席	囊 NzDu
党 单方面	囊 虫よ
党 发起人	囊 o_H
党 发言人	囊 oēH
党 分庭抗礼	囊 だxк搂
党 共存	囊 @s
党 共	囊 @
党 坚持	囊 绊
党 让出	囊 琵X
党 提出	囊 矗X
党 推出	囊 崩X
党 宣布独立	囊 钮Wミ
党 选出	囊 匡X
党 主席	囊 Du
党 作出	囊 @X
荡 阶段	亢 顶q
荡 秋	亢 
档 布	郎 ガ
档 出口	郎 Xf
档 家具	郎 aㄣ
刀 威逼	M 鹿G
倒 针布	 wガ
岛 格林	q 妾L
岛 共有	q @Τ
岛 国家	q 瓣a
岛 已开发	q w}o
到 昂	 
到 巴格达	 ぺ婀F
到 报名	 厨W
到 铲	 藐
到 城市	 哎
到 出产	 X玻
到 出境	 X挂
到 出口	 Xf
到 出	 X
到 当年	 讽~
到 地板	 aO
到 独家新闻	 WasD
到 发达	 oF
到 发稿	 oZ
到 发展	 oi
到 发	 o
到 丰润	 伦柬
到 丰	 伦
到 哥伦比亚	 舡郅瘿
到 格	 
到 公共汽车站	 そ@Tó
到 共产党员	 @玻囊
到 共产主义	 @玻Dq
到 共和国	 @M瓣
到 共青团	 @C刮
到 共同	 @P
到 国家	 瓣a
到 痕迹	 勃格
到 技术	 мN
到 家事	 aㄆ
到 家喻户晓	 a畴め惧
到 价格	 基
到 坚持不懈	 绊ぃ居
到 坚持	 绊
到 江苏	 磕
到 胶布	 溅ガ
到 敬	 q
到 巨额	 エB
到 开发	 }o
到 柳暗花明	 ht岍
到 伦敦	 鄞
到 明显	 陪
到 农家	 Aa
到 派出所	 ％X┮
到 前列腺	 eC涪
到 秋高气爽	 畎鸩n
到 秋	 
到 肉类	 ψ摸
到 深入浅出	 `JLX
到 苏联	 默p
到 苏州	 默{
到 苏	 默
到 宿舍	 J
到 塌陷	 厄炒
到 提出	 矗X
到 突出	 馥X
到 晚秋	 边
到 万分	 Uだ
到 万人	 UH
到 万无一失	 UL@ア
到 王家	 a
到 西藏	 杪
到 演出	 tX
到 医疗	 洛励
到 亿万	 货U
到 遭受	 D
到 植树	 从攫
到 中产阶级	 い玻顶
到 主席台	 Dux
到 作出	 @X
到 作家	 @a
稻 插秧	_ 础
稻 秧苗	_ 杯]
道 并	D }
道 采取	D 蹦
道 出发	D Xo
道 出口	D Xf
道 出来	D Xㄓ
道 出现	D X{
道 出	D X
道 发生	D oネ
道 放出	D 癀X
道 格	D 
道 共同努力	D @PVO
道 共	D @
道 坚固	D 绊T
道 开发	D }o
道 摩托车	D 集Λó
道 默	D q
道 树	D 攫
道 提出	D 矗X
道 遗迹	D 框格
道 战况	D 驹p
道 植树	D 从攫
道 指出	D X
道 作出	D @X
德 并	w }
德 布	w ガ
德 采	w 蹦
德 出席	w Xu
德 发出	w oX
德 发生	w oネ
德 发	w o
德 共同	w @P
德 国家	w 瓣a
德 火山爆发	w 酩szo
德 家	w a
德 拉出	w ┰X
德 伦	w 
德 贸易额	w T雒B
德 签署	w 帽p
德 签	w 帽
德 树	w 攫
德 苏联	w 默p
德 苏	w 默
德 提出	w 矗X
德 指出	w X
德 专家	w Ma
德 诙谐	w 纲坑
得 出版	o X
得 出名	o XW
得 出奇	o X_
得 出	o X
得 大家	o ja
得 发抖	o oл
得 发亮	o oG
得 发展	o oi
得 丰	o 伦
得 复发	o _o
得 格外	o 妤~
得 共同	o @P
得 国家元首	o 瓣aじ
得 家人	o aH
得 焦头烂额	o JY年B
得 流下	o yU
得 拿出	o 偿X
得 全家	o a
得 水泄不通	o 舄nぃq
得 突出	o 馥X
得 脱口而出	o 叉fτX
得 万	o U
得 一塌糊涂	o @厄k额
得 艺术	o 美N
的 阿根廷	 讧
的 矮小	 Gp
的 矮	 G
的 安全帽	 wU
的 昂贵	 Q
的 昂	 
的 巴尔干国家	 ぺ焊F瓣a
的 巴格达	 ぺ婀F
的 百万吨	 κU痉
的 百万	 κU
的 板	 O
的 薄板	 痢O
的 报名	 厨W
的 爆发	 zo
的 杯	 M
的 背后	 I
的 背景	 I春
的 背面	 I
的 背心	 Iみ
的 背	 I
的 扁桃	 螽
的 并	 }
的 玻璃板	 良O
的 搏斗	 i矮
的 驳斥	 婚ジ
的 卜	 R
的 不结盟国家	 ぃ挡幅瓣a
的 布告	 ガi
的 布拉格	 ガ┰
的 布料	 ガ
的 布鞋	 ガc
的 布	 ガ
的 财务状况	 ]叭p
的 采访	 蹦X
的 采购	 蹦潦
的 采集	 蹦栋
的 采掘	 蹦备
的 采矿	 蹦q
的 采纳	 蹦
的 采用	 蹦ノ
的 采	 蹦
的 菜板	 垫O
的 草案	 螽
的 测试	 代刚
的 茶杯	 M
的 茶楼	 加
的 差额	 tB
的 搀扶	 eн
的 撤出	 MX
的 城市	 哎
的 痴呆	 扶b
的 痴	 扶
的 崇敬	 Rq
的 出版社	 X┆
的 出版者	 X┆
的 出版	 X
的 出发点	 XoI
的 出国	 X瓣
的 出口货	 Xff
的 出口贸易	 XfT
的 出口商	 Xf坝
的 出口	 Xf
的 出力	 XO
的 出路	 X隔
的 出勤率	 X对v
的 出勤	 X对
的 出色	 X
的 出神入化	 XJて
的 出生率	 Xネv
的 出土	 Xg
的 出席	 Xu
的 出现	 X{
的 出租汽车	 X波Tó
的 出	 X
的 传家宝	 肚a_
的 串	 
的 达赖喇嘛	 F苦斥估
的 打斗	 ゴ矮
的 大丰收	 j伦Μ
的 大奖杯	 j贱M
的 丹青	 うC
的 单方面	 虫よ
的 当家作主	 讽a@D
的 到家	 飚a
的 堤	 出
的 地质学家	 a借厩a
的 电焊	 qk
的 电话铃	 q杠a
的 电子显示器	 ql陪ボ竟
的 雕刻版	 Jㄨ
的 雕刻	 Jㄨ
的 雕塑	 J鹅
的 雕像	 J钩
的 顶峰	 郴p
的 冬青树	 VC攫
的 斗争	 矮
的 斗	 矮
的 缎	 v
的 多伦多	 h郐h
的 额头	 BY
的 额外	 B~
的 额	 B
的 发表	 o
的 发布	 oガ
的 发财	 o]
的 发达	 oF
的 发呆	 ob
的 发电厂	 oqt
的 发电机	 oq诀
的 发电	 oq
的 发动机	 o笆诀
的 发动	 o笆
的 发放	 o
的 发挥	 o揣
的 发掘	 o备
的 发明者	 o
的 发明	 o
的 发票	 o布
的 发起人	 o_H
的 发起	 o_
的 发射	 og
的 发生	 oネ
的 发现者	 o{
的 发现	 o{
的 发祥地	 o不a
的 发行	 o
的 发言权	 oēv
的 发言人	 oēH
的 发扬光大	 o喘j
的 发音	 o
的 发源地	 o方a
的 发展	 oi
的 发	 o
的 烦恼	 沸o
的 饭菜	 逗垫
的 方格	 よ
的 非战斗人员	 D驹矮H
的 分发	 だo
的 分析家	 だRa
的 奋斗	 灸矮
的 奋发	 灸o
的 丰	 伦
的 风格	 樊
的 扶持	 н
的 扶植	 н从
的 扶	 н
的 浮雕	 BJ
的 复苏	 _默
的 概况	 阀p
的 概要	 阀n
的 盖板	 \O
的 感想	 PQ
的 钢板	 葵O
的 哥伦比亚	 舡郅瘿
的 歌唱家	 q佰a
的 革命家	 博Ra
的 格调	 娼
的 格局	 妲
的 格	 
的 隔板	 jO
的 隔音板	 j氮O
的 工匠	 uK
的 攻坚	 ю绊
的 功率输出	 \v块X
的 公报	 そ厨
的 公布	 そガ
的 公共汽车	 そ@Tó
的 公共	 そ@
的 公仆	 そ共
的 共产党员	 @玻囊
的 共产党	 @玻囊
的 共产主义	 @玻Dq
的 共和党	 @M囊
的 共和国	 @M瓣
的 共鸣	 @伙
的 共青团	 @C刮
的 共识	 @醚
的 共同基础	 @P膀娄
的 共同目标	 @Pヘ夹
的 共同努力	 @PVO
的 共同市场	 @Pカ初
的 共同	 @P
的 共有	 @Τ
的 共	 @
的 沟渠	 肪措
的 骨质疏松症	 癌借波Pg
的 雇员	 侗
的 官方公报	 xよそ厨
的 观察家	 [诡a
的 光束	 
的 规格	 W
的 轨迹	 y格
的 桂树	 劬
的 国家安全法	 瓣awk
的 国家预算	 瓣aw衡
的 国家元首	 瓣aじ
的 国家	 瓣a
的 果树	 G攫
的 哈密瓜	 ⒈Kナ
的 海堤	 出
的 海伦	 
的 焊缝	 k_
的 焊接	 k钡
的 航程	 璧{
的 航迹	 韪
的 和平共处	 Mキ@B
的 合格	 X
的 黑板	 堵O
的 痕迹	 勃格
的 葫芦	 脯莫
的 糊涂	 k额
的 滑板	 菲O
的 画家	 ea
的 化学家	 て厩a
的 化妆品	 てЗ~
的 欢笑	 w
的 皇家	 赢a
的 婚姻	 B
的 婚	 B
的 火力发电厂	 酩Ooqt
的 迹	 格
的 极为	 伐
的 集思广益	 栋浼sq
的 挤出	 澜X
的 脊背	 岘I
的 技术人员	 мNH
的 技术援助	 мN穿U
的 技术	 мN
的 祭奠	 步楚
的 家长	 a
的 家境	 a挂
的 家具	 aㄣ
的 家门	 a
的 家禽	 aV
的 家人	 aH
的 家属	 a妮
的 家庭教育	 ax毙|
的 家庭生活	 axネ
的 家庭式	 axΑ
的 家庭手工业	 axもu~
的 家庭主妇	 axD包
的 家庭	 ax
的 家务	 a叭
的 家乡	 am
的 家信	 aH
的 家畜	 ab
的 家用	 aノ
的 家园	 a堕
的 家政学	 aF厩
的 家族	 a壁
的 家	 a
的 加工技术	 [uмN
的 甲板	 ヒO
的 价格	 基
的 架构	 [c
的 坚持	 绊
的 坚定	 绊w
的 坚固	 绊T
的 坚决	 绊M
的 坚实	 绊龟
的 坚挺	 绊
的 坚硬	 绊w
的 坚	 绊
的 尖端技术	 y狠мN
的 江苏	 磕
的 疆土	 忙g
的 降雨量	 矮Bq
的 降雨	 矮B
的 胶合板	 溅XO
的 脚板	 }O
的 教育家	 毙|a
的 揭发	 处o
的 阶段	 顶q
的 阶级斗争	 顶虐
的 杰出	 城X
的 结婚	 挡B
的 解释	 秆睦
的 金额	 髅B
的 金婚	 鞅B
的 紧张	 候i
的 进出口贸易	 iXfT
的 进出口商	 iXf坝
的 进出口	 iXf
的 进出	 iX
的 近况	 癃p
的 经济学家	 g蕾厩a
的 景况	 春p
的 颈部	 V场
的 颈椎	 V凑
的 境况	 挂p
的 敬礼	 q搂
的 敬佩	 qㄘ
的 敬意	 qN
的 敬重	 q
的 局部	 Ы场
的 巨额	 エB
的 决议草案	 M某螽
的 开采	 }蹦
的 开发	 }o
的 看家本领	 莓aセ烩
的 考场	 σ初
的 考古学家	 σj厩a
的 科学家	 炀钱a
的 课堂	 揭绑
的 课题	 揭D
的 苦斗	 W矮
的 苦恼	 Wo
的 裤带	 壳a
的 裤管	 壳恨
的 裤腿	 壳L
的 快板	 еO
的 款额	 蹿B
的 喇叭声	 斥zn
的 喇叭	 斥z
的 喇嘛	 斥估
的 老家	 ρa
的 理论家	 z阶a
的 联合公报	 pXそ厨
的 疗法	 励k
的 疗	 励
的 列宁格勒	 C圭姘
的 零售价格	 s扳基
的 领头	 烩Y
的 柳树	 h攫
的 楼房	 加┬
的 漏洞	 |}
的 伦敦	 鄞
的 螺丝帽	 脸捣U
的 罗布	 霉ガ
的 妈妈	 洱洱
的 马术	 皑N
的 漫画家	 憨ea
的 漫画	 憨e
的 漫	 憨
的 帽子	 Ul
的 贸易壁垒	 T鼍缆S
的 贸易额	 T雒B
的 美术史	 Nv
的 美术	 N
的 弥漫	 辣憨
的 面值	 杯
的 明显	 陪
的 名额	 WB
的 名誉主席	 WADu
的 摩托车	 集Λó
的 默	 q
的 母校	 ダ
的 木板	 れO
的 木匠	 れK
的 内部斗争	 ず场矮
的 能工巧匠	 啶uォK
的 能够	 喟
的 农家	 Aa
的 农舍	 A
的 女画家	 kea
的 女作家	 k@a
的 拍照	 ╃酚
的 配额	 tB
的 佩	 ㄘ
的 批驳	 у婚
的 批发折扣	 уoчΙ
的 批发	 уo
的 品格	 ~
的 乒乓球	 モャy
的 乒乓	 モャ
的 扑	 汲
的 仆仆风尘	 共共饭
的 企业家	 ~a
的 启发	 币o
的 千秋	 d
的 签名	 帽W
的 签署	 帽p
的 签章	 帽彻
的 签证	 帽谍
的 签字	 帽r
的 签	 帽
的 前列腺	 eC涪
的 潜能	 肩
的 亲笔信	 克掸H
的 亲戚	 克杯
的 情况	 薄p
的 秋风	 瞽
的 趋向	 镣V
的 曲面	 Ρ
的 缺额	 拭B
的 人格	 H
的 人迹	 H格
的 人口分布	 Hfだガ
的 人类学家	 H摸厩a
的 人头税	 HY|
的 肉类	 ψ摸
的 塞浦路斯	 峨隔吹
的 散发	 床o
的 沙发	 Fo
的 摄影家	 尼va
的 生活状况	 ネ―p
的 生物学家	 ネ厩a
的 十万	 QU
的 石匠	 ホK
的 石油输出国组织	 ホo块X瓣舱麓
的 实况	 龟p
的 视线	 跌u
的 手术室	 もN
的 手术	 もN
的 售票处	 扳布B
的 殊荣	 砗a
的 殊	 
的 输出	 块X
的 书法家	 血ka
的 署名文章	 pWゅ彻
的 术语	 Ny
的 树干	 攫F
的 树立	 攫ミ
的 树林	 攫L
的 树苗	 攫]
的 树木	 攫れ
的 树叶	 攫腑
的 树枝	 攫K
的 树	 攫
的 数额	 计B
的 水土保持	 簸gO
的 水土流失	 簸gyア
的 税额	 |B
的 思潮	 浼
的 思想斗争	 浞Q矮
的 思想家	 浞Qa
的 苏丹	 默う
的 苏格兰	 默婺
的 苏联	 默p
的 苏州	 默{
的 苏	 默
的 宿舍	 J
的 塌陷	 厄炒
的 桃树	 缇
的 特殊	 S
的 提出	 矗X
的 天伦之乐	 ぱ郅Ъ
的 天文学家	 ぱゅ厩a
的 挑战	 D驹
的 跳板	 铬O
的 突出	 馥X
的 涂料	 额
的 涂	 额
的 托管	 Λ恨
的 托	 Λ
的 拓荒者	 ┹瞠
的 外交家	 ~ユa
的 外来	 ~ㄓ
的 万分	 Uだ
的 万里长城	 U姜
的 万人	 UH
的 万	 U
的 违法	 Hk
的 违反	 Hは
的 文章	 ゅ彻
的 梧桐树	 憋渚
的 武术	 ZN
的 五颜六色	 きCせ
的 西藏	 杪
的 溪涧	 匪碱
的 宪法草案	 舅k螽
的 限额	 B
的 销售总额	 P扳`B
的 校舍	 摘
的 鞋匠	 cK
的 协议草案	 竽朝螽
的 新婚夫妇	 sBひ包
的 新闻公报	 sDそ厨
的 心弦	 み┒
的 心脏移植	 み纽簿从
的 形态	 魏A
的 行家	 娈a
的 性格	 ┦
的 性能测试	 ┦啻刚
的 宣布	 钮
的 悬殊	 a
的 学术交流	 厩Nユy
的 学术论文	 厩N阶ゅ
的 学术	 厩N
的 熏	 饫
的 鸭舌帽	 n薮U
的 亚洲开发银行	 ㄈw}o蝗
的 严格	 Y
的 演出	 tX
的 演说家	 t弧a
的 秧苗	 杯]
的 摇钱树	 n窥攫
的 一连串	 @s
的 医疗保健	 洛励O胺
的 医疗用品	 洛励ノ~
的 医疗	 洛励
的 医术	 洛N
的 依托	 ㄌΛ
的 遗迹	 框格
的 已婚	 wB
的 艺术家	 美Na
的 艺术节	 美N`
的 艺术	 美N
的 亿万	 货U
的 意识	 N醚
的 义演	 qt
的 音乐家	 导之a
的 婴孩	 捆
的 赢家	 墓a
的 映出	 MX
的 优异	 u钵
的 有限	 Τ
的 有线电视	 Τuq跌
的 幼发拉底河	 ギo┰┏e
的 语言学家	 yē厩a
的 预测	 w代
的 预算草案	 w衡螽
的 造型艺术	 y美N
的 战场	 驹初
的 战车	 驹ó
的 战斗机	 驹矮诀
的 战斗力	 驹矮O
的 战斗	 驹矮
的 战况	 驹p
的 战略家	 驹菠a
的 战术	 驹N
的 针布	 wガ
的 诊疗	 E励
的 政治家	 Fva
的 政治体制	 Fv砰
的 支出	 やX
的 直布罗陀	 渐霉
的 植树节	 从攫`
的 植树	 从攫
的 植物学家	 从厩a
的 治疗	 v励
的 中产阶级	 い玻顶
的 中非共和国	 いD@M瓣
的 中华人民共和国	 い地Hチ@M瓣
的 中坚	 い绊
的 种树	 贺攫
的 主席台	 Dux
的 主席团	 Du刮
的 主席	 Du
的 专家	 Ma
的 专门	 M
的 状况	 p
的 追悼会	 l饱|
的 资格	 戈
的 仔细	 J灿
的 自发性	 鄣o┦
的 自发	 鄣o
的 踪迹	 萝格
的 总工程师	 `u{v
的 总共	 `@
的 足迹	 ì格
的 尊敬	 Lq
的 作家	 @a
的 作曲家	 @Ρa
的 作用比	 @ノゑ
的 匾额	 靶B
的 憧憬	 讥缉
的 珀	 
登 布	n ガ
登 坚	n 绊
登 主席	n Du
等 矮	单 G
等 败家子	单 毖al
等 别具一格	单 Oㄣ@
等 采取	单 蹦
等 采用	单 蹦ノ
等 草案	单 螽
等 城市	单 哎
等 出版社	单 X┆
等 出口商	单 Xf坝
等 出席	单 Xu
等 额	单 B
等 发表	单 o
等 发布	单 oガ
等 发达	单 oF
等 发生	单 oネ
等 发展	单 oi
等 发	单 o
等 奋斗	单 灸矮
等 丰	单 伦
等 公共事业	单 そ@ㄆ~
等 公共	单 そ@
等 共计	单 @p
等 共同	单 @P
等 共	单 @
等 国家	单 瓣a
等 果树	单 G攫
等 画家	单 ea
等 技术	单 мN
等 家具	单 aㄣ
等 家务	单 a叭
等 家用	单 aノ
等 家	单 a
等 开发	单 }o
等 课题	单 揭D
等 名家	单 Wa
等 情况	单 薄p
等 手术	单 もN
等 树	单 攫
等 思潮	单 浼
等 苏联	单 默p
等 特殊	单 S
等 提出	单 矗X
等 突出	单 馥X
等 万	单 U
等 违法乱纪	单 Hk睹
等 违法	单 Hk
等 违反	单 Hは
等 违犯	单 Hデ
等 文章	单 ゅ彻
等 西欧国家	单 杓诎戤a
等 西医	单 杪
等 学术	单 厩N
等 演出	单 tX
等 医疗设备	单 洛励]称
等 艺术	单 美N
等 意识	单 N醚
等 战场	单 驹初
等 战斗	单 驹矮
等 治疗	单 v励
等 专家	单 Ma
等 专门	单 M
等 作家	单 @a
等 作曲家	单 @Ρa
凳 坚固	构 绊T
邓 布	H ガ
邓 家	H a
堤 安	出 w
堤 坝	出 膨
堤 成功	出 Θ\
堤 大	出 j
堤 的	出 
堤 都	出 常
堤 堆	出 帮
堤 防	出 
堤 合	出 X
堤 记	出 O
堤 建	出 
堤 决口	出 Mf
堤 林	出 L
堤 上	出 W
堤 外	出 ~
堤 下面	出 U
堤 下	出 U
堤 烟	出 废
堤 堰	出 橱
堤 远眺	出 环卜
堤 在	出 b
堤 筑	出 诞
堤 纵	出 a
低 矮	C G
低 出	C X
低 发	C o
低 技术	C мN
迪 出	} X
迪 格	} 
迪 指出	} X
狄 格	f 
翟 树	C 攫
翟 万	C U
抵 巴格达	╄ ぺ婀F
抵 伦敦	╄ 鄞
抵 苏	╄ 默
抵 万象	╄ UH
底 采用	┏ 蹦ノ
底 查出	┏ dX
底 出嫁	┏ X儿
底 发生	┏ oネ
底 格	┏ 
底 共	┏ @
底 提出	┏ 矗X
底 宣布	┏ 钮
底 状况	┏ p
地 安家落户	a wa辅め
地 搬家	a ha
地 板条	a O兵
地 杯盘狼藉	a MLT虑
地 背	a I
地 奔走相告	a bǐ郄i
地 播放	a 冀
地 采访	a 蹦X
地 采集	a 蹦栋
地 采取	a 蹦
地 采用	a 蹦ノ
地 测试	a 代刚
地 查出	a dX
地 铲	a 藐
地 超额	a WB
地 撤出	a MX
地 成千上万	a ΘdWU
地 澄清	a 坚M
地 出版	a X
地 出发	a Xo
地 出来	a Xㄓ
地 出售	a X扳
地 出席	a Xu
地 出现	a X{
地 出	a X
地 串	a 
地 打拳	a ゴ
地 定额	a wB
地 发表	a o
地 发出	a oX
地 发动	a o笆
地 发挥作用	a o揣@ノ
地 发挥	a o揣
地 发射	a og
地 发送	a oe
地 发现	a o{
地 发扬光大	a o喘j
地 发展	a oi
地 发	a o
地 奋斗	a 灸矮
地 扶植	a н从
地 付出	a IX
地 共	a @
地 鼓掌	a 躬x
地 焊接	a k钡
地 回家	a ^a
地 汲	a V
地 家	a a
地 坚持	a 绊
地 坚决	a 绊M
地 坚守	a 绊u
地 坚信	a 绊H
地 降雨量	a 矮Bq
地 解释	a 秆睦
地 紧张	a 候i
地 敬礼	a q搂
地 敬	a q
地 开发	a }o
地 看出	a 荪X
地 流下	a yU
地 露出	a SX
地 弥漫	a 辣憨
地 拿出	a 偿X
地 拍照	a ╃酚
地 批发商	a уo坝
地 批发	a уo
地 情况	a 薄p
地 树立	a 攫ミ
地 竖起	a 捷_
地 水力发电	a 簸Ooq
地 说出	a 弧X
地 提出	a 矗X
地 体验	a 砰喷
地 剃	a c
地 突出	a 馥X
地 推出	a 崩X
地 托	a Λ
地 脱口而出	a 叉fτX
地 违背	a HI
地 违反	a Hは
地 宣布	a 钮
地 严格	a Y
地 演出	a tX
地 移植	a 簿从
地 意识到	a N醚
地 预测	a w代
地 遭受	a D
地 知情	a 颈
地 植树	a 从攫
地 指出	a X
地 治疗	a v励
地 仔细	a J灿
地 走出	a ǐX
地 作出	a @X
蒂 昂	甫 
蒂 并	甫 }
蒂 格	甫 
递 出	患 X
掂 出	i X
点 采访	I 蹦X
点 城市	I 哎
点 出发	I Xo
点 出售	I X扳
点 出	I X
点 发布	I oガ
点 发稿	I oZ
点 扶植	I н从
点 公报	I そ厨
点 公布	I そガ
点 共	I @
点 焊	I k
点 技术	I мN
点 开发	I }o
点 作出	I @X
典 作家	ㄥ @a
垫 布	乖 ガ
垫 塌陷	乖 厄炒
电 爆发	q zo
电 并	q }
电 铲	q 藐
电 发展	q oi
电 技术	q мN
电 价格	q 基
电 结婚	q 挡B
电 苏联	q 默p
电 万	q U
电 映出	q MX
店 发	┍ o
店 扔出	┍ サX
雕 比赛	J ゑ辽
雕 大	J j
雕 代表	J N
雕 给	J 倒
雕 会	J |
雕 杰作	J 城@
雕 梁	J 辩
雕 取材	J 
雕 石英钟	J ホ^牧
雕 协会	J 蠓|
雕 艺术品	J 美N~
雕 艺术	J 美N
雕 预赛	J w辽
雕 在	J b
雕 凿	J w
掉 家	奔 a
吊 杯	Q M
吊 盖板	Q \O
调 出售	秸 X扳
调 出	秸 X
调 发达	秸 oF
调 技术	秸 мN
迭 现出	 {X
叠 出	| X
丁 杯	B M
丁 格	B 
顶 草帽	郴 蟠U
顶 帽子	郴 Ul
定 并	w }
定 出	w X
定 合格	w X
定 技术	w мN
定 数额	w 计B
定 限额	w B
定 植树	w 从攫
订 采	q 蹦
订 出口	q Xf
订 出来	q Xㄓ
订 出	q X
订 当年	q 讽~
订 国家	q 瓣a
订 技术	q мN
订 解释	q 秆睦
订 进出口贸易	q iXfT
订 医疗	q 洛励
东 布	F ガ
东 出口商	F Xf坝
东 出席	F Xu
东 发生	F oネ
东 发	F o
东 丰	F 伦
东 开发	F }o
东 提出	F 矗X
东 托	F Λ
东 西欧国家	F 杓诎戤a
东 指出	F X
冬 共	V @
冬 已开发	V w}o
董 家	赋 a
董 树	赋 攫
懂 技术	来 мN
懂 艺术	来 美N
动 并	笆 }
动 技术	笆 мN
栋 家	瓷 a
洞 采取	} 蹦
斗 车	矮 ó
斗 吃	矮 Y
斗 持	矮 
斗 歹徒	矮 わ{
斗 的	矮 
斗 地	矮 a
斗 风	矮 
斗 海	矮 
斗 和	矮 M
斗 焕	矮 坟
斗 机	矮 诀
斗 角	矮 à
斗 金	矮 
斗 酷暑	矮 慌椿
斗 兰	矮 孽
斗 门	矮 
斗 奇	矮 _
斗 沙	矮 F
斗 士	矮 h
斗 是	矮 O
斗 危	矮 M
斗 凶犯	矮 たデ
斗 雪	矮 撤
斗 严寒	矮 YH
斗 艳	矮 A
斗 勇	矮 i
斗 志	矮 в
斗 转	矮 锣
都 采纳	常 蹦
都 采取	常 蹦
都 采用	常 蹦ノ
都 铲	常 藐
都 超额	常 WB
都 出乎	常 XG
都 出去	常 Xh
都 出色	常 X
都 出现	常 X{
都 出	常 X
都 打出	常 ゴX
都 当家	常 讽a
都 到场	常 斐
都 发出	常 oX
都 发光	常 o
都 发挥	常 o揣
都 发生	常 oネ
都 发展	常 oi
都 付出	常 IX
都 格外	常 妤~
都 和盘托出	常 MLΛX
都 合格	常 X
都 极为	常 伐
都 挤出	常 澜X
都 坚持	常 绊
都 坚定	常 绊w
都 流下	常 yU
都 明显	常 陪
都 拿出	常 偿X
都 能够	常 喟
都 排出	常 逼X
都 跑出	常 ]X
都 扑	常 汲
都 签	常 帽
都 让出	常 琵X
都 扔下	常 サU
都 舍	常 
都 伸出	常 X
都 提出	常 矗X
都 推出	常 崩X
都 违反	常 Hは
都 想家	常 Qa
都 严格	常 Y
都 意识到	常 N醚
都 因事外出	常 ]ㄆ~X
都 有希望	常 Τ票
都 指出	常 X
都 作出	常 @X
毒 斗争	r 矮
毒 治疗	r v励
独 家	W a
读 出来	弄 Xㄓ
读 出	弄 X
睹 苏联	@ 默p
杜 布	 ガ
杜 家	 a
度 并	 }
度 采取	 蹦
度 出现	 X{
度 出	 X
度 春秋	 K
度 发生	 oネ
度 共同	 @P
度 共	 @
度 国家	 瓣a
度 技术	 мN
度 情况	 薄p
度 战术	 驹N
度 中秋	 い
渡 扶	寸 н
端 杯	狠 M
端 出来	狠 Xㄓ
短 发	u o
段 爆发	q zo
段 并	q }
段 出现	q X{
段 敦厚	q 窗p
段 共生	q @ネ
段 共有	q @Τ
段 共	q @
段 腊梅	q 镁宾
段 苏	q 默
段 挑战	q D驹
缎 带	v a
缎 的	v 
缎 柜台	v dx
缎 和	v M
缎 料	v 
缎 向	v V
堆 家	帮 a
堆 罗布	帮 霉ガ
队 颁发	钉 {o
队 采取	钉 蹦
队 采	钉 蹦
队 初出茅庐	钉 欹XTf
队 出发	钉 Xo
队 出	钉 X
队 发出	钉 oX
队 发挥	钉 o揣
队 发起	钉 o_
队 发现	钉 o{
队 发言人	钉 oēH
队 发展	钉 oi
队 发	钉 o
队 共同	钉 @P
队 共有	钉 @Τ
队 共	钉 @
队 回家	钉 ^a
队 坚持	钉 绊
队 坚守	钉 绊u
队 近况	钉 癃p
队 开发	钉 }o
队 排出	钉 逼X
队 宿舍	钉 J
队 外出	钉 ~X
队 有希望	钉 Τ票
队 遭受	钉 D
队 总共	钉 `@
队 作出	钉 @X
对 阿根廷	癸 讧
对 昂	癸 
对 并	癸 }
对 布	癸 ガ
对 采访	癸 蹦X
对 采矿	癸 蹦q
对 采	癸 蹦
对 草案	癸 螽
对 查出	癸 dX
对 超额	癸 WB
对 城市	癸 哎
对 出场	癸 X初
对 出口商	癸 Xf坝
对 出口	癸 Xf
对 出入	癸 XJ
对 出租	癸 X
对 出	癸 X
对 大家	癸 ja
对 当年	癸 讽~
对 二甲苯	癸 Gヒf
对 发达	癸 oF
对 发生	癸 oネ
对 发育不良	癸 o|ぃ}
对 发展	癸 oi
对 丰	癸 伦
对 扶持	癸 н
对 扶	癸 н
对 格	癸 
对 共产党	癸 @玻囊
对 共产主义	癸 @玻Dq
对 共和国	癸 @M瓣
对 共青团	癸 @C刮
对 共同安全	癸 @Pw
对 共同	癸 @P
对 国家	癸 瓣a
对 合格	癸 X
对 化妆品	癸 てЗ~
对 回家	癸 ^a
对 婚姻	癸 B
对 技术	癸 мN
对 家长	癸 a
对 家人	癸 aH
对 家庭	癸 ax
对 家乡	癸 am
对 家用	癸 aノ
对 家	癸 a
对 价格	癸 基
对 坚持	癸 绊
对 江苏	癸 磕
对 解释	癸 秆睦
对 金婚	癸 鞅B
对 进出口商	癸 iXf坝
对 进出口	癸 iXf
对 进出	癸 iX
对 开采	癸 }蹦
对 开发	癸 }o
对 考古学家	癸 σj厩a
对 妈妈	癸 洱洱
对 梅树	癸 宾攫
对 民族学	癸 チ壁厩
对 能够	癸 喟
对 乒乓球	癸 モャy
对 扑灭	癸 汲防
对 千千万万	癸 ddUU
对 情况	癸 薄p
对 全家	癸 a
对 日出	癸 らX
对 肉类	癸 ψ摸
对 塞浦路斯	癸 峨隔吹
对 石油输出国组织	癸 ホo块X瓣舱麓
对 苏联	癸 默p
对 苏	癸 默
对 特殊	癸 S
对 托	癸 Λ
对 外来	癸 ~ㄓ
对 万	癸 U
对 违背	癸 HI
对 违法	癸 Hk
对 违反	癸 Hは
对 违犯	癸 Hデ
对 西藏	癸 杪
对 现阶段	癸 {顶q
对 新婚夫妇	癸 sBひ包
对 新婚	癸 sB
对 医疗	癸 洛励
对 移植	癸 簿从
对 艺术	癸 美N
对 有线新闻	癸 ΤusD
对 战斗	癸 驹矮
对 蒸馏	癸 ]H
对 支出	癸 やX
对 植树	癸 从攫
对 治疗中	癸 v励い
对 治疗	癸 v励
对 中华人民共和国	癸 い地Hチ@M瓣
对 作出	癸 @X
墩 杯	[ M
吨 出口	痉 Xf
顿 杯	y M
盾 当年	 讽~
多 并	h }
多 布	h ガ
多 采取	h 蹦
多 采用	h 蹦ノ
多 采	h 蹦
多 出自	h X
多 出	h X
多 串	h 
多 发生	h oネ
多 发	h o
多 格	h 
多 公顷	h そ臣
多 共青团	h @C刮
多 共同	h @P
多 雇员	h 侗
多 国家	h 瓣a
多 家人	h aH
多 家	h a
多 解释	h 秆睦
多 卖出	h 芥X
多 拿出	h 偿X
多 凄凉	h YD
多 情况	h 薄p
多 树	h 攫
多 苏联	h 默p
多 万年	h U~
多 万人	h UH
多 万	h U
多 医疗	h 洛励
多 支出	h やX
多 种树	h 贺攫
夺 丰	管 伦
鹅 开发	Z }o
额 把	B р
额 百	B κ
额 包	B ]
额 保险费	B OIO
额 报酬	B 厨S
额 比	B ゑ
额 并	B }
额 补	B 干
额 不得	B ぃo
额 不足	B ぃì
额 不	B ぃ
额 才	B ~
额 超过	B WL
额 超	B W
额 呈	B e
额 持续	B 尿
额 创	B 承
额 从	B q
额 达到	B F
额 达	B F
额 大	B j
额 的	B 
额 第一	B 材@
额 定期存单	B w戳s虫
额 定	B w
额 都	B 常
额 度	B 
额 尔	B 焊
额 翻	B 陆
额 费用	B Oノ
额 分别	B だO
额 高	B 蔼
额 共	B @
额 估计	B 舡p
额 挂	B 本
额 好	B n
额 和	B M
额 合计达	B XpF
额 很	B 
额 互换	B が传
额 回扣	B ^Ι
额 回	B ^
额 汇款	B 蹲蹿
额 技	B м
额 计	B p
额 减少	B 搭ぶ
额 将	B N
额 较	B 耕
额 仅	B 度
额 近	B 
额 经	B g
额 就近	B N
额 就	B N
额 居	B ~
额 剧	B @
额 均	B А
额 砍	B 
额 看	B 
额 可	B i
额 肯定	B 蜘w
额 扩大	B Xj
额 累计	B 仓p
额 立	B ミ
额 连年	B s~
额 连续	B s尿
额 每年	B C~
额 猛	B r
额 木	B れ
额 目前	B ヘe
额 难以	B 螟H
额 情况	B 薄p
额 去年	B h~
额 却	B o
额 人	B H
额 仍	B ご
额 如今	B pさ
额 如	B p
额 锐	B U
额 上升	B Wど
额 上	B W
额 是	B O
额 收费	B ΜO
额 收购	B Μ潦
额 收	B Μ
额 首次	B 害
额 缩小	B Yp
额 同	B P
额 突破	B 鸠}
额 完成	B ЧΘ
额 为	B 
额 五十	B きQ
额 下降	B U
额 相当	B 鄯
额 销售	B P扳
额 迅速	B ǔt
额 也	B ]
额 已	B w
额 以	B H
额 用	B ノ
额 由	B パ
额 有	B Τ
额 又	B S
额 逾	B O
额 与	B P
额 预计	B wp
额 远远	B 环环
额 约	B 
额 越来越	B VㄓV
额 在	B b
额 则	B h
额 增长	B W
额 增加	B W[
额 增	B W
额 占	B 
额 之后	B ぇ
额 之	B ぇ
额 直线	B 浇u
额 指标	B 夹
额 只	B u
额 制	B 
额 中	B い
额 逐	B v
额 主要	B Dn
额 转	B 锣
额 自然	B 鄣M
额 最大	B 程j
额 最多	B 程h
额 最	B 程
娥 解释	Z 秆睦
鄂 伦	k 
恩 布	 ガ
恩 撤出	 MX
恩 出席	 Xu
恩 格	 
恩 苏	 默
恩 提出	 矗X
恩 万	 U
恩 政府发言人	 F┎oēH
恩 政治家	 Fva
恩 作出	 @X
而 昂	τ 
而 爆发	τ zo
而 并	τ }
而 采取	τ 蹦
而 采用	τ 蹦ノ
而 崇敬	τ Rq
而 出口	τ Xf
而 出生	τ Xネ
而 出现	τ X{
而 出	τ X
而 斗争	τ 矮
而 发表	τ o
而 发财	τ o]
而 发愁	τ oT
而 发达	τ oF
而 发挥	τ o揣
而 发生	τ oネ
而 发展	τ oi
而 奋斗	τ 灸矮
而 付出	τ IX
而 共同努力	τ @PVO
而 共同	τ @P
而 共	τ @
而 国家	τ 瓣a
而 家庭教育	τ ax毙|
而 价格	τ 基
而 坚持不懈	τ 绊ぃ居
而 坚持	τ 绊
而 坚挺	τ 绊
而 洛阳	τ ザ
而 漫	τ 憨
而 千头万绪	τ dYU狐
而 树立	τ 攫ミ
而 苏联	τ 默p
而 苏州	τ 默{
而 苏	τ 默
而 提出	τ 矗X
而 突出	τ 馥X
而 西藏	τ 杪
而 宣布	τ 钮
而 严格	τ Y
而 引发	τ まo
而 映出	τ MX
而 踊跃	τ 裤D
而 预测	τ w代
而 遭受	τ D
而 战斗	τ 驹矮
而 专家	τ Ma
而 作出	τ @X
儿 出版社	ㄠ X┆
儿 出生	ㄠ Xネ
儿 紧张	ㄠ 候i
儿 美术	ㄠ N
儿 乒乓球	ㄠ モャy
儿 艺术	ㄠ 美N
耳 布	φ ガ
尔 并	焊 }
尔 布	焊 ガ
尔 采购	焊 蹦潦
尔 采	焊 蹦
尔 出境	焊 X挂
尔 出生	焊 Xネ
尔 出席	焊 Xu
尔 出	焊 X
尔 发电厂	焊 oqt
尔 发难	焊 o螟
尔 发生	焊 oネ
尔 共和国	焊 @M瓣
尔 共同	焊 @P
尔 共	焊 @
尔 国家元首	焊 瓣aじ
尔 家	焊 a
尔 坚持	焊 绊
尔 默	焊 q
尔 佩	焊 ㄘ
尔 签署	焊 帽p
尔 全家	焊 a
尔 摄影家	焊 尼va
尔 苏	焊 默
尔 提出	焊 矗X
尔 托	焊 Λ
尔 万	焊 U
尔 宣布	焊 钮
尔 指出	焊 X
尔 主席团	焊 Du刮
尔 主席	焊 Du
尔 作出	焊 @X
二 采	G 蹦
发 案	o 
发 把	o р
发 白内障	o フず毁
发 百	o κ
发 斑白	o 闯フ
发 保	o O
发 碧眼	o 貉泊
发 病人	o fH
发 病	o f
发 补	o 干
发 不到	o ぃ
发 不仅	o ぃ度
发 不	o ぃ
发 苍	o a
发 长得	o o
发 长袖	o S
发 厂长	o t
发 臭	o 
发 出生	o Xネ
发 除	o 埃
发 此	o 
发 从不	o qぃ
发 粗	o 彩
发 脆	o 
发 村	o 
发 大	o j
发 代表	o N
发 袋	o U
发 当选	o 讽匡
发 当	o 讽
发 导致	o 旧P
发 到了	o 欷F
发 到	o 
发 得	o o
发 的	o 
发 等	o 单
发 低	o C
发 地区	o a跋
发 第	o 材
发 店	o ┍
发 东西	o F
发 都	o 常
发 短评	o u蝶
发 对	o 癸
发 多少	o hぶ
发 多	o h
发 而	o τ
发 罚	o @
发 纺织品	o 悸传~
发 分析	o だR
发 肤	o 涧
发 讣告	o ri
发 甘肃	o ヌ德
发 感谢	o P谅
发 膏	o I
发 个	o 
发 各种	o U贺
发 各	o U
发 工具	o uㄣ
发 工作	o u@
发 公告	o そi
发 公函	o そㄧ
发 购	o 潦
发 姑娘	o hQ
发 广东	o sF
发 广西	o s
发 国有	o 瓣Τ
发 过	o L
发 海味	o 
发 函	o ㄧ
发 航	o 
发 好	o n
发 号召	o 腹l
发 呵	o 
发 和	o M
发 河北	o e_
发 河南	o en
发 很	o 
发 红	o 
发 后	o 
发 花白	o 幞
发 黄	o 独
发 会议	o |某
发 或	o ┪
发 货物	o f
发 货	o f
发 基因	o 膀]
发 及	o の
发 脊柱	o 岈W
发 佳	o ㄎ
发 家	o a
发 价格	o 基
发 简单	o 虏虫
发 江苏	o 磕
发 江西	o 喀
发 奖金	o 贱
发 奖品	o 贱~
发 奖	o 贱
发 角	o à
发 接	o 钡
发 解放军	o 秆癍x
发 今天	o さぱ
发 进度	o i
发 精	o 弘
发 井	o か
发 救济	o 毕蕾
发 就	o N
发 局	o Ы
发 决赛	o M辽
发 开	o }
发 可	o i
发 奎	o 
发 拉	o ┰
发 来	o ㄓ
发 廊	o Y
发 劳动者	o 骋笆
发 老人	o ρH
发 老	o ρ
发 离	o 瞒
发 理事会	o zㄆ|
发 礼	o 搂
发 力	o O
发 辽宁	o 狂圭
发 了	o F
发 列车	o Có
发 裂	o 吊
发 林	o L
发 临时	o {
发 零	o s
发 领导	o 烩旧
发 令	o O
发 螺	o 脸
发 满	o 骸
发 帽子	o Ul
发 没	o S
发 面	o 
发 命令	o RO
发 南方	o nよ
发 农贷	o AU
发 努	o V
发 女	o k
发 炮	o 
发 配	o t
发 披肩	o ┸
发 品	o ~
发 扑克牌	o 汲JP
发 期	o 戳
发 企业	o ~
发 汽车	o Tó
发 抢救	o m毕
发 青年	o C~
发 青	o C
发 清	o M
发 庆	o y
发 球	o y
发 区	o 跋
发 去年	o h~
发 去	o h
发 全部	o 场
发 全	o 
发 券	o ㄩ
发 却	o o
发 染	o V
发 热量	o 荐q
发 人	o H
发 软	o n
发 三	o T
发 傻	o 短
发 善	o 到
发 上海	o W
发 上月	o Wる
发 少年	o ぶ~
发 少	o ぶ
发 涉及	o Aの
发 身	o ō
发 生产	o ネ玻
发 生物	o ネ
发 省	o 
发 师	o v
发 十	o Q
发 时	o 
发 式	o Α
发 事件	o ㄆン
发 势	o 墩
发 是	o O
发 市	o カ
发 收入	o ΜJ
发 水	o 
发 税款	o |蹿
发 说	o 弧
发 丝	o 捣
发 四川	o |t
发 宋	o Ш
发 速	o t
发 他	o L
发 塔	o 娥
发 烫	o S
发 田	o バ
发 通知	o q
发 童	o 担
发 统一	o 参@
发 投	o щ
发 推	o 崩
发 退休	o hヰ
发 外	o ~
发 晚报	o 边厨
发 万	o U
发 为	o 
发 委员	o e
发 文件	o ゅン
发 文章	o ゅ彻
发 卧	o 
发 握住	o 搐
发 屋	o 
发 西德	o 杓w
发 洗	o ~
发 细胞性	o 灿M┦
发 先生	o ネ
发 显示	o 陪ボ
发 乡	o m
发 向	o V
发 新华社	o s地
发 新	o s
发 型	o 
发 性	o ┦
发 修饰	o 坠
发 修整	o 拙
发 需要	o 惠n
发 蓄	o W
发 宣传	o 哦
发 言	o ē
发 央	o ァ
发 扬	o 喘
发 痒	o }
发 要求	o nD
发 爷爷	o 份份
发 也	o ]
发 业	o ~
发 一	o @
发 依	o ㄌ
发 仪式	o 祸Α
发 椅	o 慈
发 已经	o wg
发 用	o ノ
发 员	o 
发 怨言	o 瑷
发 云南	o 冻n
发 运	o B
发 再生	o Aネ
发 在	o b
发 债	o 杜
发 战争	o 驹
发 浙江	o 
发 症	o g
发 证	o 谍
发 之后	o ぇ
发 职	o 戮
发 至	o 
发 制	o 
发 中子	o いl
发 中	o い
发 终	o 沧
发 重	o 
发 主持	o D
发 著	o 帝
发 抓	o ъ
发 资料	o 戈
发 紫	o 档
发 子弹	o lu
发 自	o 
发 做	o 暗
发 座谈会	o y酵|
发 鱿鱼	o {辰
伐 限额	ワ B
乏 出	F X
乏 共同	F @P
乏 疗	F 励
乏 有希望	F Τ票
阀 万	恢 U
法 并	k }
法 草案	k 螽
法 出主意	k XDN
法 发展	k oi
法 共同	k @P
法 共	k @
法 坚持	k 绊
法 伦	k 
法 情况	k 薄p
法 托	k Λ
法 政治家	k Fva
法 治疗	k v励
法 作出	k @X
帆 板	| O
翻 出	陆 X
翻 斗	陆 矮
凡 出版	Z X
凡 共产党员	Z @玻囊
凡 国家	Z 瓣a
凡 合格	Z X
凡 提出	Z 矗X
凡 违反	Z Hは
凡 中华人民共和国	Z い地Hチ@M瓣
反 国家	は 瓣a
反 扑	は 汲
反 映出	は MX
范 颁发	S {o
范 并	S }
范 发表	S o
范 共产党员	S @玻囊
范 共青团	S @C刮
范 国家	S 瓣a
范 技术	S мN
范 家庭	S ax
范 家	S a
范 阶段	S 顶q
范 敬	S q
范 演出	S tX
贩 并	c }
犯 搏斗	デ i矮
犯 恼羞成怒	デ o槽Θ
泛 出	x X
芳 出席	 Xu
方 颁发	よ {o
方 采取	よ 蹦
方 出场	よ X初
方 出席	よ Xu
方 发展	よ oi
方 发	よ o
方 共识	よ @醚
方 共同努力	よ @PVO
方 技术人员	よ мNH
方 技术	よ мN
方 家	よ a
方 坚持	よ 绊
方 开发	よ }o
方 能够	よ 喟
方 签	よ 帽
方 提出	よ 矗X
方 违反	よ Hは
方 严格	よ Y
方 预测	よ w代
方 指出	よ X
方 主席	よ Du
方 作出	よ @X
房 采访	┬ 蹦X
房 出售	┬ X扳
房 出	┬ X
房 开发	┬ }o
防 并	 }
防 发生	 oネ
防 技术	 мN
防 术	 N
访 国家	X 瓣a
访 敬	X q
访 农家	X Aa
访 亲戚	X 克杯
访 苏联	X 默p
访 苏	X 默
访 万	X U
访 西藏	X 杪
访 演出	X tX
纺 出口	 Xf
纺 有限公司	 Τそq
放 测试	 代刚
放 扶	 н
放 化妆品	 てЗ~
放 疗	 励
放 明显	 陪
菲 出席	滇 Xu
菲 发明	滇 o
菲 国家	滇 瓣a
菲 舍	滇 
菲 演出	滇 tX
非 采	D 蹦
非 出版	D X
非 出兵	D XL
非 出乎预料	D XGw
非 出口	D Xf
非 出现	D X{
非 出	D X
非 发起	D o_
非 发生	D oネ
非 发展	D oi
非 共产党	D @玻囊
非 共和国	D @M瓣
非 共同市场	D @Pカ初
非 共同	D @P
非 国家银行	D 瓣a蝗
非 国家	D 瓣a
非 婚	D B
非 能够	D 喟
非 签署	D 帽p
非 石油输出国组织	D ホo块X瓣舱麓
非 手术	D もN
非 退出	D hX
非 宣布	D 钮
非 作出	D @X
飞 铲	 藐
飞 出	 X
飞 作出	 @X
肥 出售	 X扳
肥 发	 o
肥 价格	 基
肥 情况	 薄p
肥 星罗棋布	 P霉囱ガ
匪 浅	 L
匪 中	 い
废 树脂	o 攫
费 尔格	O 焊
费 金额	O 髅B
费 伦	O 
费 支出	O やX
芬 共	 @
芬 苏	 默
芬 专家	 Ma
分 并	だ }
分 布	だ ガ
分 出	だ X
分 发射	だ og
分 发生	だ oネ
分 发展	だ oi
分 阶段	だ 顶q
分 树木	だ 攫れ
分 走下	だ ǐU
粉 妆	 З
份 草案	 螽
份 超额	 WB
份 出口	 Xf
份 出席	 Xu
份 出现	 X{
份 额外	 B~
份 额	 B
份 发电	 oq
份 发给	 o倒
份 发生	 oネ
份 发展	 oi
份 发	 o
份 公报	 そ厨
份 共	 @
份 官方公报	 xよそ厨
份 国家	 瓣a
份 合格	 X
份 技术	 мN
份 决议草案	 M某螽
份 批发	 уo
份 情况	 薄p
份 新闻公报	 sDそ厨
份 预测	 w代
份 主席	 Du
丰 碑	伦 O
丰 宾馆	伦 猾]
丰 补	伦 干
丰 采	伦 蹦
丰 草	伦 
丰 产	伦 玻
丰 的	伦 
丰 登	伦 n
丰 度	伦 
丰 富	伦 I
丰 根据	伦 诰
丰 功	伦 \
丰 和	伦 M
丰 厚	伦 p
丰 华	伦 地
丰 坚持	伦 绊
丰 凯	伦 惩
丰 离	伦 瞒
丰 林	伦 L
丰 禄	伦 S
丰 满	伦 骸
丰 美	伦 
丰 民	伦 チ
丰 南	伦 n
丰 年	伦 ~
丰 歉	伦 p
丰 去	伦 h
丰 塞	伦 峨
丰 商场	伦 坝初
丰 盛	伦 脖
丰 收	伦 Μ
丰 说	伦 弧
丰 硕	伦 河
丰 台	伦 x
丰 田	伦 バ
丰 投资	伦 щ戈
丰 威风凛凛	伦 颅坊箕
丰 威	伦 
丰 委员	伦 e
丰 县	伦 郡
丰 乡	伦 m
丰 雄	伦 动
丰 宣传	伦 哦
丰 衣	伦 
丰 以	伦 H
丰 银行	伦 蝗
丰 盈利	伦 乍Q
丰 盈	伦 
丰 有限公司	伦 Τそq
丰 裕	伦 肝
丰 在	伦 b
丰 镇	伦 马
丰 之后	伦 ぇ
丰 转	伦 锣
丰 姿	伦 
丰 足	伦 ì
丰 胄	伦 `
丰 稔	伦 Z
封 家信	 aH
封 亲笔信	 克掸H
蜂 采	噶 蹦
峰 冰雕	p BJ
峰 挑战	p D驹
峰 托	p Λ
锋 并	W }
锋 出	W X
锋 激发	W Eo
锋 家乡	W am
锋 坚定	W 绊w
锋 明显	W 陪
锋 树	W 攫
风 采	 蹦
风 发	 o
风 提出	 矗X
风 作出	 @X
逢 秋雨	{ 瞰B
逢 植树节	{ 从攫`
冯 家	毒 a
凤 斗	获 矮
否 出席	_ Xu
否 坚持	_ 绊
夫 出	ひ X
夫 发表	ひ o
夫 发布	ひ oガ
夫 共和国	ひ @M瓣
夫 解释	ひ 秆睦
夫 签署	ひ 帽p
夫 舍	ひ 
夫 苏联	ひ 默p
夫 提出	ひ 矗X
夫 万	ひ U
夫 指出	ひ X
夫 主席	ひ Du
夫 作出	ひ @X
扶 残	н 摧
扶 村	н 
扶 到	н 
扶 沟	н 肪
扶 科	н 
扶 困	н x
扶 老人	н ρH
扶 犁	н p
扶 门框	н 
扶 您	н z
扶 贫户	н hめ
扶 贫	н h
扶 墙	н 鲤
扶 桑	н 
扶 上	н W
扶 送到	н e
扶 他	н L
扶 拖拉机	н ╈┰诀
扶 下车	н Uó
扶 小组	н p舱
扶 一	н @
扶 勇气	н i
扶 优	н u
扶 幼	н ギ
扶 正气	н タ
扶 正	н タ
扶 著	н 帝
扶 住	н 
幅 布	T ガ
幅 出自	T X
幅 哥伦比亚	T 舡郅瘿
幅 明显	T 陪
幅 签名	T 帽W
幅 苏联	T 默p
幅 涂抹	T 额┵
幅 有限	T Τ
幅 针布	T wガ
氟 里昂	t 僵
氟 树脂	t 攫
伏 家	ヱ a
伏 秋	ヱ 
浮 出	B X
福 格	褐 
福 国家	褐 瓣a
福 家乡	褐 am
福 家	褐 a
福 全家	褐 a
福 万	褐 U
福 指出	褐 X
弗 格	ケ 
弗 伦	ケ 
弗 主席	ケ Du
抚 情况	季 薄p
府 发表	┎ o
府 发言人	┎ oēH
腐 意识	G N醚
赴 阿根廷	u 讧
赴 出事地点	u XㄆaI
赴 出事	u Xㄆ
赴 国家	u 瓣a
赴 江苏	u 磕
赴 苏联	u 默p
赴 苏州	u 默{
赴 苏	u 默
赴 西藏	u 杪
副 发言人	捌 oēH
副 结婚	捌 挡B
副 主席	捌 Du
副 总工程师	捌 `u{v
复 出	_ X
复 发生	_ oネ
复 情况	_ 薄p
复 指出	_ X
傅 家	撑 a
付 额	I B
付 家	I a
付 针布	I wガ
负 大家	t ja
负 西藏	t 杪
富 并	I }
富 发展	I oi
富 家	I a
富 启发	I 币o
富 西藏	I 杪
富 悬殊	I a
嘎 家	骨 a
嘎 宣布	骨 钮
该 逼迫	赣 G
该 并	赣 }
该 采取	赣 蹦
该 草案	赣 螽
该 撤出	赣 MX
该 城市	赣 哎
该 发挥	赣 o揣
该 发言人	赣 oēH
该 发展	赣 oi
该 共和国	赣 @M瓣
该 共同市场	赣 @Pカ初
该 共同	赣 @P
该 坚决	赣 绊M
该 树立	赣 攫ミ
该 珍惜	赣 帽
该 指出	赣 X
改 出	э X
盖 格	\ 
盖 帽	\ U
盖 宿舍	\ J
盖 油布	\ oガ
干 杯	F M
干 布	F ガ
干 出来	F Xㄓ
干 出	F X
干 发	F o
干 共	F @
干 家务	F a叭
干 家	F a
干 农家	F Aa
甘 布	ヌ ガ
甘 家	ヌ a
杆 共同	 @P
肝 爆发	x zo
赶 出口	话 Xf
赶 回家	话 ^a
感 并	P }
感 技术	P мN
感 苦恼	P Wo
感 预测	P w代
敢 动手术	幢 笆もN
敢 焊	幢 k
敢 藐	幢 缕
冈 矮	 G
冈 家	 a
刚 爆发	 zo
刚 采访	 蹦X
刚 出版	 X
刚 出生	 Xネ
刚 出	 X
刚 发生	 oネ
刚 家	 a
刚 结婚	 挡B
刚 开发	 }o
刚 说出	 弧X
刚 推出	 崩X
刚 走出	 ǐX
刚 走下	 ǐU
钢 杯	葵 M
钢 成千上万	葵 ΘdWU
钢 出口	葵 Xf
钢 出售	葵 X扳
钢 斗	葵 矮
钢 发展	葵 oi
钢 共产党员	葵 @玻囊
钢 共同	葵 @P
钢 国家	葵 瓣a
钢 技术	葵 мN
钢 坚持不懈	葵 绊ぃ居
钢 坚持	葵 绊
钢 模板	葵 家O
钢 十万	葵 QU
钢 提出	葵 矗X
钢 推出	葵 崩X
缸 发酵	 o幻
港 杯	翠 M
港 采访	翠 蹦X
港 出发	翠 Xo
港 出口	翠 Xf
港 共	翠 @
港 签署	翠 帽p
港 学术交流	翠 厩Nユy
港 学术	翠 厩N
港 演出	翠 tX
高 矮	蔼 G
高 昂	蔼 
高 板	蔼 O
高 并	蔼 }
高 采	蔼 蹦
高 出	蔼 X
高 额	蔼 B
高 发热	蔼 o荐
高 发	蔼 o
高 风格	蔼 樊
高 格调	蔼 娼
高 规格	蔼 W
高 国家	蔼 瓣a
高 技术	蔼 мN
高 家	蔼 a
高 开发	蔼 }o
高 拉起	蔼 ┰_
高 疗	蔼 励
高 树林	蔼 攫L
高 苏维埃	蔼 默蝴J
高 提出	蔼 矗X
高 限额	蔼 B
高 艺术	蔼 美N
膏 治疗	I v励
搞 出来	d Xㄓ
搞 出	d X
搞 共同	d @P
搞 火力发电	d 酩Ooq
搞 技术	d мN
搞 开发	d }o
搞 特殊化	d S恧
搞 特殊	d S
搞 西藏	d 杪
稿 草案	Z 螽
稿 作出	Z @X
告 指出	i X
哥 布	 ガ
哥 发表	 o
哥 共和国	 @M瓣
哥 心脏移植	 み纽簿从
歌 并	q }
歌 丰	q 伦
歌 艺术	q 美N
戈 发现	む o{
鸽 并	F }
割 舍	澄 
革 坚持	 绊
格 奥	 而
格 把	 р
格 班	 Z
格 邦	 ü
格 比	 ゑ
格 并	 }
格 勃	 k
格 查	 d
格 出售	 X扳
格 从	 q
格 达到	 F
格 达	 F
格 担任	 踞ヴ
格 但	 
格 到	 
格 道	 D
格 德	 w
格 的	 
格 地区	 a跋
格 电子	 ql
格 对	 癸
格 尔格	 焊
格 尔	 焊
格 甘	 ヌ
格 格	 
格 给	 倒
格 古	 j
格 圭	 c
格 和	 M
格 还	 临
格 回顾	 ^U
格 或	 ┪
格 吉	 N
格 将军	 Nx
格 将	 N
格 教授	 毙甭
格 接替	 钡蠢
格 今天	 さぱ
格 今晚	 さ边
格 晋升	 胜
格 就	 N
格 举行	 |
格 开到	 }
格 拉	 ┰
格 来	 ㄓ
格 兰	 孽
格 勒	 扒
格 雷	 p
格 里拉	 僵
格 里	 
格 丽	 R
格 利	 Q
格 列	 C
格 陵	 钞
格 鲁	 |
格 律诗	 吒
格 率领	 v烩
格 罗	 霉
格 洛	 
格 玛	 嚎
格 曼	 耙
格 梅	 宾
格 木	 れ
格 纳	 
格 南	 n
格 内	 ず
格 尼	 ェ
格 年	 ~
格 涅	 I
格 努	 V
格 诺	 空
格 平等	 キ单
格 平	 キ
格 强调	 j秸
格 弱点	 zI
格 萨	 履
格 三	 T
格 桑	 
格 森	 此
格 上将	 WN
格 上校	 W
格 上	 W
格 什	 ぐ
格 是	 O
格 授予	 甭ぉ
格 输油管	 块o恨
格 说	 弧
格 斯	 吹
格 苏木	 默れ
格 索	 
格 太	 び
格 特	 S
格 提拔	 矗┺
格 提升	 矗ど
格 同	 P
格 王朝	 绰
格 微	 L
格 为首	 碍
格 为	 
格 维	 蝴
格 现	 {
格 县	 郡
格 亚	 ㄈ
格 宴请	 b叫
格 扬	 喘
格 一	 @
格 已	 w
格 由	 パ
格 在	 b
格 则	 h
格 扎	 蚕
格 吱	 s
格 致	 P
格 制度	 瞰
格 州	 {
格 转	 锣
格 总理	 `z
隔 出	j X
个 矮	 G
个 巴格达	 ぺ婀F
个 百万	 κU
个 报名	 厨W
个 背	 I
个 表格	 懋
个 采购	 蹦潦
个 采用	 蹦ノ
个 采	 蹦
个 草案	 螽
个 测试	 代刚
个 茶杯	 M
个 城市	 哎
个 初出茅庐	 欹XTf
个 出版社	 X┆
个 出场	 X初
个 出发点	 XoI
个 出口	 Xf
个 出力	 XO
个 出名	 XW
个 出生	 Xネ
个 出租汽车	 X波Tó
个 出	 X
个 春秋	 K
个 大丰收	 j伦Μ
个 大家	 ja
个 戴眼镜	 拦泊描
个 单方面	 虫よ
个 斗争	 矮
个 额	 B
个 发达	 oF
个 发掘	 o备
个 发生	 oネ
个 发现	 o{
个 发展	 oi
个 发	 o
个 丰	 伦
个 扶	 н
个 公报	 そ厨
个 共产党员	 @玻囊
个 共产党	 @玻囊
个 共产主义	 @玻Dq
个 共和国	 @M瓣
个 共识	 @醚
个 共同目标	 @Pヘ夹
个 共同	 @P
个 共	 @
个 规格	 W
个 国家	 瓣a
个 果树	 G攫
个 焊接	 k钡
个 合格	 X
个 葫芦	 脯莫
个 极为	 伐
个 技术人员	 мNH
个 技术	 мN
个 家庭手工业	 axもu~
个 家庭	 ax
个 家用	 aノ
个 家政学	 aF厩
个 家	 a
个 价格	 基
个 坚持	 绊
个 坚实	 绊龟
个 坚	 绊
个 阶段	 顶q
个 杰出	 城X
个 金婚	 鞅B
个 进出口	 iXf
个 敬	 q
个 开发	 }o
个 科学家	 炀钱a
个 课题	 揭D
个 联合公报	 pXそ厨
个 疗	 励
个 明显	 陪
个 名额	 WB
个 摩托车	 集Λó
个 能够	 喟
个 农家	 Aa
个 派出所	 ％X┮
个 批发	 уo
个 签字	 帽r
个 亲戚	 克杯
个 情况	 薄p
个 秋	 
个 塞浦路斯	 峨隔吹
个 沙发	 Fo
个 伸出	 X
个 树	 攫
个 苏联	 默p
个 苏木	 默れ
个 素昧平生	 垃Nキネ
个 宿舍	 J
个 特殊	 S
个 体外受精	 砰~弘
个 挑战	 D驹
个 铜板	 簧O
个 突出	 馥X
个 脱颖而出	 叉oτX
个 万	 U
个 违法	 Hk
个 限额	 B
个 鞋匠	 cK
个 性格	 ┦
个 选出	 匡X
个 学术	 厩N
个 严格	 Y
个 演出	 tX
个 医疗	 洛励
个 艺术	 美N
个 意识	 N醚
个 织布	 麓ガ
个 植树节	 从攫`
个 植树	 从攫
个 专家	 Ma
个 专门委员会	 Me|
个 专门	 M
个 状况	 p
个 资本家	 戈セa
个 子系统	 lt参
个 总公司	 `そq
个 总共	 `@
各 布	U ガ
各 城市	U 哎
各 出版社	U X┆
各 出兵	U XL
各 发生	U oネ
各 发	U o
各 共和国	U @M瓣
各 共	U @
各 技术	U мN
各 家门	U a
各 家	U a
各 阶段	U 顶q
各 进出口商	U iXf坝
各 进出口	U iXf
各 课题	U 揭D
各 批发	U уo
各 签约	U 帽
各 学术	U 厩N
各 演出	U tX
各 艺术	U 美N
各 专门委员会	U Me|
给 板	倒 O
给 布	倒 ガ
给 茶杯	倒 M
给 城市	倒 哎
给 出席	倒 Xu
给 大家	倒 ja
给 发展	倒 oi
给 丰	倒 伦
给 哥伦比亚	倒 舡郅瘿
给 格	倒 
给 共和国	倒 @M瓣
给 共同	倒 @P
给 国家	倒 瓣a
给 化妆品	倒 てЗ~
给 家长	倒 a
给 家家户户	倒 aaめめ
给 家庭	倒 ax
给 家乡	倒 am
给 家	倒 a
给 角膜病	倒 à饯f
给 开发票	倒 }o布
给 能够	倒 喟
给 农家	倒 Aa
给 签	倒 帽
给 树木	倒 攫れ
给 苏联	倒 默p
给 苏	倒 默
给 万	倒 U
给 西藏	倒 杪
给 新婚	倒 sB
给 亿万	倒 货U
给 中华人民共和国	倒 い地Hチ@M瓣
根 扁担	 缶
根 茶杯	 M
根 出席	 Xu
根 雕	 J
根 家	 a
根 颈	 V
根 舍	 
根 树	 攫
跟 大家	蛤 ja
跟 斗	蛤 矮
跟 共产党	蛤 @玻囊
跟 家属	蛤 a妮
跟 乒乓球	蛤 モャy
耕 技术	 мN
耕 秋	 
耕 植树	 从攫
更 出现	 X{
更 丰	 伦
更 激发	 Eo
更 坚定	 绊w
更 坚固	 绊T
更 坚决	 绊M
更 坚韧	 绊洞
更 坚实	 绊龟
更 特殊	 S
更 显出	 陪X
更 严格	 Y
更 优异	 u钵
更 有希望	 Τ票
工 卜	u R
工 布	u ガ
工 出差	u Xt
工 出勤率	u X对v
工 出色	u X
工 出主意	u XDN
工 出	u X
工 当家作主	u 讽a@D
工 当家	u 讽a
工 发出	u oX
工 发放	u o
工 发挥	u o揣
工 发现	u o{
工 发	u o
工 奋发向上	u 灸oVW
工 付出	u IX
工 共同	u @P
工 共	u @
工 集思广益	u 栋浼sq
工 技术	u мN
工 家属	u a妮
工 家庭	u ax
工 家务	u a叭
工 家	u a
工 坚持	u 绊
工 坚决	u 绊M
工 坚守	u 绊u
工 美术	u N
工 签名	u 帽W
工 签	u 帽
工 情况	u 薄p
工 生活状况	u ネ―p
工 树立	u 攫ミ
工 宿舍	u J
工 提出	u 矗X
工 托儿所	u Λㄠ┮
工 万	u U
工 违反	u Hは
工 医疗保健	u 洛励O胺
工 艺术	u 美N
工 意识到	u N醚
工 织布	u 麓ガ
工 种树	u 贺攫
工 专门	u M
工 自发	u 鄣o
功 并	\ }
功 奋发	\ 灸o
功 疗法	\ 励k
功 题诗	\ D钢
恭 出国	 X瓣
恭 恭敬	 シq
供 出口	ㄑ Xf
供 皇家	ㄑ 赢a
供 签署	ㄑ 帽p
公 出差	そ Xt
公 出生	そ Xネ
公 家庭	そ ax
公 外出	そ ~X
宫 管弦乐队	c 恨┒贾钉
宫 竞技场	c vм初
宫 派出所	c ％X┮
宫 签署	c 帽p
宫 演出	c tX
弓 出席	} Xu
贡 布	^ ガ
共 安徽	@ w啦
共 安排	@ w逼
共 安装	@ w杆
共 八	@ K
共 百	@ κ
共 办理	@ 快z
共 办	@ 快
共 保	@ O
共 爆发	@ zo
共 北方	@ _よ
共 北京	@ _ㄊ
共 北平	@ _キ
共 奔	@ b
共 病	@ f
共 播	@ 冀
共 拨款	@ 挤蹿
共 拨	@ 挤
共 部署	@ 场p
共 裁员	@ 掉
共 才	@ ~
共 采纳	@ 蹦
共 采	@ 蹦
共 参加	@ 把[
共 参与	@ 把P
共 查出	@ dX
共 查收	@ dΜ
共 查	@ d
共 拆除	@ ╊埃
共 拆	@ ╊
共 产生	@ 玻ネ
共 长期	@ 戳
共 长沙	@ F
共 长	@ 
共 超支	@ Wや
共 超	@ W
共 撤	@ M
共 成交	@ Θユ
共 乘	@ 
共 承办	@ ┯快
共 承包	@ ┯]
共 承保	@ ┯O
共 承担	@ ┯踞
共 承	@ ┯
共 抽查	@ ┾d
共 抽	@ ┾
共 筹	@ w
共 出版	@ X
共 出动	@ X笆
共 出口	@ Xf
共 出让	@ X琵
共 出	@ X
共 处理	@ Bz
共 创造	@ 承y
共 创	@ 承
共 从	@ q
共 促	@ P
共 达	@ F
共 打破	@ ゴ}
共 打死	@ ゴ
共 打	@ ゴ
共 大连	@ js
共 带	@ a
共 代表团	@ N砉
共 代表	@ N
共 代理	@ Nz
共 担	@ 踞
共 丹	@ う
共 挡住	@ 咀
共 党员	@ 囊
共 盗窃	@ s叛
共 得	@ o
共 的	@ 
共 地方党委	@ aよ囊e
共 地下	@ aU
共 第八	@ 材K
共 第	@ 材
共 调查	@ 秸d
共 调整	@ 秸俱
共 调	@ 秸
共 订	@ q
共 东	@ F
共 动土	@ 笆g
共 动员	@ 笆
共 度	@ 
共 渡	@ 寸
共 对外	@ 癸~
共 对	@ 癸
共 夺	@ 管
共 儿童	@ ㄠ担
共 发表	@ o
共 发放	@ o
共 发掘出	@ o备X
共 发掘	@ o备
共 发射	@ og
共 发生	@ oネ
共 发送	@ oe
共 发现	@ o{
共 发展	@ oi
共 罚款	@ @蹿
共 繁	@ c
共 防止	@ 兢
共 放映	@ 瘳M
共 分	@ だ
共 封	@ 
共 福建	@ 褐
共 副	@ 捌
共 复	@ _
共 负	@ t
共 富	@ I
共 改造	@ эy
共 干部	@ F场
共 甘苦	@ ヌW
共 甘肃	@ ヌ德
共 肝胆相照	@ xx鄯
共 各	@ U
共 给	@ 倒
共 更	@ 
共 购	@ 潦
共 管	@ 恨
共 广东	@ sF
共 贵州	@ Q{
共 过	@ L
共 哈尔滨	@ ⒑咐
共 海	@ 
共 核	@ 
共 和平	@ Mキ
共 合作	@ X@
共 河北省	@ e_
共 河南省	@ en
共 贺	@ P
共 黑龙江	@ 堵s
共 湖北	@ 打_
共 湖南	@ 打n
共 话	@ 杠
共 欢	@ w
共 换	@ 传
共 患难	@ w螟
共 回收	@ ^Μ
共 惠	@ f
共 混	@ V
共 获得	@ 莉o
共 获	@ 莉
共 基	@ 膀
共 吉林	@ NL
共 集结	@ 栋挡
共 集资	@ 栋戈
共 及	@ の
共 挤出	@ 澜X
共 济	@ 蕾
共 寄	@ H
共 加固	@ [T
共 加	@ [
共 坚决	@ 绊M
共 检查	@ 浪d
共 检验	@ 浪喷
共 检疫	@ 浪
共 检	@ 浪
共 建立	@ 廿
共 建设	@ 爻]
共 建	@ 
共 将	@ N
共 江苏	@ 磕
共 江西	@ 喀
共 讲	@ 量
共 交给	@ ユ倒
共 交	@ ユ
共 缴纳	@ 煤
共 缴	@ 煤
共 接待	@ 钡
共 接到	@ 钡
共 接收	@ 钡Μ
共 接受	@ 钡
共 接	@ 钡
共 节省	@ `
共 节约	@ `
共 节	@ `
共 结	@ 挡
共 解雇	@ 秆侗
共 解决	@ 秆M
共 界	@ 
共 介绍	@ ざ残
共 进行	@ i
共 进	@ i
共 净	@ b
共 九	@ E
共 举行	@ |
共 举	@ |
共 聚集	@ E栋
共 聚	@ E
共 捐	@ 
共 决裂	@ M吊
共 决	@ M
共 开办	@ }快
共 开发	@ }o
共 开封	@ }
共 开会	@ }|
共 开垦	@ }玖
共 开设	@ }]
共 开行	@ }
共 开	@ }
共 兰	@ 孽
共 理	@ z
共 历史上	@ 菌vW
共 利用	@ Qノ
共 立案	@ ミ
共 立	@ ミ
共 联合	@ pX
共 联盟	@ p幅
共 两	@ ㄢ
共 辽宁	@ 狂圭
共 领导	@ 烩旧
共 六	@ せ
共 漏	@ |
共 旅	@ 
共 绿化	@ 厚て
共 埋葬	@ I府
共 盟	@ 幅
共 猛	@ r
共 密切	@ Kち
共 命运	@ RB
共 莫斯科	@ 馋吹
共 闹	@ x
共 内蒙古	@ ずXj
共 念	@ ├
共 宁波	@ 圭i
共 排演	@ 逼t
共 派	@ 
共 培养	@ 蚌i
共 培育	@ 蚌|
共 培	@ 蚌
共 配备	@ t称
共 朋友	@ Bね
共 批准	@ у
共 评	@ 蝶
共 扑灭	@ 汲防
共 普查	@ 炊d
共 七	@ C
共 签署	@ 帽p
共 签	@ 帽
共 前	@ e
共 谴责	@ 宁d
共 欠	@ ろ
共 抢	@ m
共 青岛	@ Cq
共 青海	@ C
共 青	@ C
共 清理	@ Mz
共 清	@ M
共 庆	@ y
共 取得	@ o
共 取消	@ 
共 泉	@ u
共 全国	@ 瓣
共 确定	@ Tw
共 确	@ T
共 人士	@ Hh
共 人	@ H
共 赛	@ 辽
共 三	@ T
共 山东	@ sF
共 山西	@ s
共 陕西	@ 阿
共 商会	@ 坝|
共 商	@ 坝
共 赏金	@ 洁
共 赏	@ 洁
共 上海	@ W
共 上	@ W
共 涉及	@ Aの
共 设计	@ ]p
共 设置	@ ]m
共 设	@ ]
共 深入	@ `J
共 深	@ `
共 沈	@ H
共 审计	@ fp
共 生产	@ ネ玻
共 十二	@ QG
共 十六	@ Qせ
共 十三	@ QT
共 十一	@ Q@
共 蚀刻	@ kㄨ
共 实际	@ 龟悔
共 实施	@ 龟I
共 实现	@ 龟{
共 使用	@ ㄏノ
共 使	@ ㄏ
共 是否	@ O_
共 是	@ O
共 收到	@ Μ
共 收购	@ Μ潦
共 收集	@ Μ栋
共 收入	@ ΜJ
共 收养	@ Μi
共 收	@ Μ
共 售	@ 扳
共 受理	@ z
共 朔	@ 
共 私	@ p
共 死亡	@ 氦`
共 四川	@ |t
共 四	@ |
共 诉	@ D
共 绥	@ k
共 损失	@ lア
共 损	@ l
共 太平	@ びキ
共 贪污	@ gγ
共 踢	@ 金
共 提出	@ 矗X
共 提	@ 矗
共 体力	@ 砰O
共 体	@ 砰
共 天津	@ ぱz
共 天	@ ぱ
共 添	@ K
共 停	@ 氨
共 通力合作	@ qOX@
共 通	@ q
共 同志	@ Pв
共 投入	@ щJ
共 投资	@ щ戈
共 投	@ щ
共 图	@ 瓜
共 推广	@ 崩s
共 推荐	@ 崩滤
共 推销	@ 崩P
共 退出	@ hX
共 瓦解	@ ニ秆
共 完成	@ ЧΘ
共 完善	@ Ч到
共 万	@ U
共 为	@ 
共 维修	@ 蝴
共 五	@ き
共 舞	@ R
共 吸收	@ lΜ
共 厦门	@ H
共 现场	@ {初
共 现在	@ {b
共 献	@ m
共 相互	@ 郅
共 向	@ V
共 销售	@ P扳
共 销	@ P
共 消化	@ て
共 谢绝	@ 谅荡
共 新疆	@ s忙
共 新	@ s
共 兴办	@ 砍快
共 兴邦	@ 砍ü
共 行程	@ 娴{
共 性	@ ┦
共 需	@ 惠
共 叙	@ 痹
共 选出	@ 匡X
共 选派	@ 匡
共 选育	@ 匡|
共 学	@ 厩
共 研究	@ 悒s
共 研	@ 
共 演出	@ tX
共 要	@ n
共 也	@ ]
共 一些	@ @ㄇ
共 一直	@ @
共 一	@ @
共 宜昌	@ y
共 宜	@ y
共 义务	@ q叭
共 议	@ 某
共 译	@ 亩
共 饮	@ 都
共 引进	@ まi
共 印	@ L
共 营造	@ 犁y
共 迎	@ 
共 拥有	@ 局Τ
共 涌	@ F
共 由	@ パ
共 邮寄	@ lH
共 与	@ P
共 育	@ |
共 愿	@ @
共 约	@ 
共 云南省	@ 冻n
共 运送	@ Be
共 运	@ B
共 栽植	@ 獯
共 栽	@ 
共 在	@ b
共 赞	@ g
共 葬	@ 府
共 造成	@ yΘ
共 造林	@ yL
共 增补	@ W干
共 增产	@ W玻
共 增加	@ W[
共 增	@ W
共 摘取	@ K
共 展	@ i
共 占	@ 
共 战	@ 驹
共 招收	@ ┷Μ
共 召开	@ l}
共 折合	@ чX
共 浙江	@ 
共 振兴	@ 犊
共 征收	@ ┖Μ
共 征	@ ┖
共 争取	@ Ж
共 整	@ 俱
共 正式	@ タΑ
共 政权	@ Fv
共 政治局	@ FvЫ
共 支持	@ や
共 支付	@ やI
共 知	@ 
共 之间	@ ぇ丁
共 植树	@ 从攫
共 植	@ 从
共 执政	@ 磅F
共 制定	@ 瞟w
共 制	@ 
共 治安	@ vw
共 治理	@ vz
共 治疗	@ v励
共 治	@ v
共 中介	@ いざ
共 中央委员	@ いァe
共 中央	@ いァ
共 重	@ 
共 主席	@ Du
共 筑	@ 诞
共 住	@ 
共 驻	@ n
共 抓	@ ъ
共 装运	@ 杆B
共 装	@ 杆
共 撞	@ 疾
共 追求	@ lD
共 追	@ l
共 自造	@ 鄢y
共 总书记	@ `寻O
共 组成	@ 舱Θ
共 组织	@ 舱麓
共 组	@ 舱
共 钻	@ p
共 最	@ 程
共 做	@ 暗
共 坐	@ Г
共 沭	@ 条
钩 共	_ @
沟 万	肪 U
购 国家	潦 瓣a
够 发达	镑 oF
够 丰	镑 伦
够 格	镑 
够 突出	镑 馥X
够 严格	镑 Y
古 巴比伦	j ぺゑ
古 格	j 
古 共	j @
古 槐树	j i攫
古 签署	j 帽p
古 生物学家	j ネ厩a
古 树根	j 攫
古 树	j 攫
古 战场	j 驹初
骨 杯	癌 M
骨 移植	癌 簿从
骨 治疗	癌 v励
谷 斗	é 矮
谷 丰	é 伦
股 额	 B
股 明显	 陪
顾 树	U 攫
顾 万	U U
瓜 指出	ナ X
挂 出来	本 Xㄓ
挂 出	本 X
挂 艺术家	本 美Na
挂 艺术品	本 美N~
挂 艺术作品	本 美N@~
怪 国家	┣ 瓣a
棺 板	疵 O
棺 共	疵 @
关 国家	闽 瓣a
关 开发	闽 }o
关 课题	闽 揭D
关 苏维埃	闽 默蝴J
关 作出	闽 @X
官 布	x ガ
官 发出	x oX
官 家	x a
官 帽	x U
冠 帽	a U
观 并	[ }
观 发生	[ oネ
管 并	恨 }
管 布	恨 ガ
管 采取	恨 蹦
管 城市	恨 哎
管 出口	恨 Xf
管 出事	恨 Xㄆ
管 发展	恨 oi
管 国家	恨 瓣a
管 开发	恨 }o
管 实行宵禁	恨 龟娈dT
管 苏	恨 默
管 提出	恨 矗X
管 治疗	恨 v励
馆 共	] @
灌 出	拈 X
贯 串	e 
光 板	 O
光 逼	 G
光 采	 蹦
光 到家	 飚a
光 缎	 v
光 家	 a
光 挑战	 D驹
光 医术	 洛N
广 出席	s Xu
轨 出现	y X{
桂 出口	 Xf
贵 家	Q a
贵 坚持	Q 绊
贵 提出	Q 矗X
贵 溪	Q 匪
郭 丰	尝 伦
郭 家	尝 a
郭 秋	尝 
郭 树	尝 攫
郭 溪	尝 匪
国 阿根廷	瓣 讧
国 薄板	瓣 痢O
国 并	瓣 }
国 采矿	瓣 蹦q
国 采取	瓣 蹦
国 采用	瓣 蹦ノ
国 城市	瓣 哎
国 出版	瓣 X
国 出口商	瓣 Xf坝
国 出口	瓣 Xf
国 出售	瓣 X扳
国 出席	瓣 Xu
国 出现	瓣 X{
国 出	瓣 X
国 发表声明	瓣 o砹n
国 发表	瓣 o
国 发明	瓣 o
国 发起	瓣 o_
国 发射	瓣 og
国 发生	瓣 oネ
国 发售	瓣 o扳
国 发现	瓣 o{
国 发行	瓣 o
国 发展	瓣 oi
国 发	瓣 o
国 格	瓣 
国 共产党	瓣 @玻囊
国 共生	瓣 @ネ
国 共同努力	瓣 @PVO
国 共同	瓣 @P
国 共用	瓣 @ノ
国 共有	瓣 @Τ
国 共	瓣 @
国 国家元首	瓣 瓣aじ
国 国家	瓣 瓣a
国 焕发	瓣 坟o
国 极为	瓣 伐
国 技术人员	瓣 мNH
国 技术	瓣 мN
国 家常	瓣 a`
国 家庭手工业	瓣 axもu~
国 家庭	瓣 ax
国 家喻户晓	瓣 a畴め惧
国 坚持	瓣 绊
国 坚定不移	瓣 绊wぃ簿
国 紧张	瓣 候i
国 进出口	瓣 iXf
国 经济学家	瓣 g蕾厩a
国 科学家	瓣 炀钱a
国 联合公报	瓣 pXそ厨
国 贸易额	瓣 T雒B
国 美术	瓣 N
国 摩托车	瓣 集Λó
国 能够	瓣 喟
国 乒乓球	瓣 モャy
国 签署	瓣 帽p
国 签	瓣 帽
国 情况	瓣 薄p
国 肉类	瓣 ψ摸
国 特殊	瓣 S
国 提出	瓣 矗X
国 外来	瓣 ~ㄓ
国 万	瓣 U
国 西藏	瓣 杪
国 现阶段	瓣 {顶q
国 演出	瓣 tX
国 已出版	瓣 wX
国 艺术	瓣 美N
国 亿万	瓣 货U
国 意识	瓣 N醚
国 政治家	瓣 Fva
国 政治体制	瓣 Fv砰
国 之外	瓣 ぇ~
国 植树	瓣 从攫
国 治疗	瓣 v励
国 专家	瓣 Ma
国 专门	瓣 M
国 作出	瓣 @X
果 层出不穷	G hXぃa
果 发展	G oi
果 丰	G 伦
果 共	G @
果 技术	G мN
果 明显	G 陪
果 作出	G @X
过 安全帽	L wU
过 百万	L κU
过 颁发	L {o
过 布	L ガ
过 堤	L 出
过 奋斗	L 灸矮
过 技术	L мN
过 家	L a
过 开发	L }o
过 漫	L 憨
过 千军万马	L dxU皑
过 苏联	L 默p
过 苏伊士运河	L 默レhBe
过 苏	L 默
过 西藏	L 杪
过 鞋匠	L cK
过 心脏移植	L み纽簿从
过 严格	L Y
哈 卜	 R
哈 布丁	 ガB
哈 布	 ガ
哈 格	 
哈 伦	 
哈 默	 q
哈 托	 Λ
孩 出生率	 Xネv
海 布	 ガ
海 城市	 哎
海 出现	 X{
海 出	 X
海 发展	 oi
海 格	 
海 共同	 @P
海 家	 a
海 开发	 }o
海 涂	 额
海 指出	 X
海 追悼会	 l饱|
害 出	` X
害 斗争	` 矮
害 发生	` oネ
害 预测	` w代
邯 邢	驼 ǚ
含 并	t }
含 出租汽车	t X波Tó
含 国家	t 瓣a
含 批发	t уo
涵 发展	[ oi
涵 指出	[ X
喊 出	驰 X
喊 妈妈	驰 洱洱
旱 斗争	 矮
旱 发挥	 o揣
旱 情况	 薄p
旱 秋	 
旱 水桶	 舯
焊 车	k ó
焊 成	k Θ
焊 等	k 单
焊 法	k k
焊 割	k 澄
焊 工	k u
焊 管	k 恨
焊 花	k 
焊 机器人	k 诀竟H
焊 机	k 诀
焊 口	k f
焊 丝	k 捣
焊 作业	k @~
汗 演出	 tX
汉 发表	~ o
汉 发生	~ oネ
汉 发往	~ o┕
汉 发	~ o
汉 共同	~ @P
汉 共	~ @
汉 家境	~ a挂
汉 家	~ a
汉 默	~ q
汉 学术	~ 厩N
汉 演出	~ tX
汉 专家	~ Ma
航 发展	 oi
航 开发	 }o
航 售票处	 扳布B
好 背包	n I]
好 并	n }
好 城市	n 哎
好 出口	n Xf
好 出	n X
好 发挥	n o揣
好 发展	n oi
好 发	n o
好 饭菜	n 逗垫
好 丰	n 伦
好 扶老携幼	n нρ拟ギ
好 扶	n н
好 共产党	n @玻囊
好 国家	n 瓣a
好 迹	n 格
好 技术	n мN
好 家庭教育	n ax毙|
好 家庭	n ax
好 家务	n a叭
好 家	n a
好 坚持	n 绊
好 进出口商	n iXf坝
好 局部	n Ы场
好 开发	n }o
好 课题	n 揭D
好 疗	n 励
好 妈妈	n 洱洱
好 品格	n ~
好 扑	n 汲
好 千头万绪	n dYU狐
好 手术	n もN
好 文章	n ゅ彻
好 西藏	n 杪
好 意识	n N醚
好 预测	n w代
好 战斗	n 驹矮
好 植树	n 从攫
耗 支出	 やX
号 发动机	腹 o笆诀
号 公报	腹 そ厨
号 帽	腹 U
号 中华人民共和国	腹 い地Hチ@M瓣
浩 发	E o
喝 采	耻 蹦
荷 专家	颤 Ma
核 爆发	 zo
核 发出	 oX
核 发电	 oq
核 发	 o
核 技术	 мN
核 物理学家	 z厩a
核 移植	 簿从
和 阿根廷	M 讧
和 矮	M G
和 百万	M κU
和 板栗	M O
和 板	M O
和 报名	M 厨W
和 杯	M M
和 蹦	M 论
和 并	M }
和 布施	M ガI
和 布鞋	M ガc
和 布宜诺斯艾利斯	M ガy空吹悃Q吹
和 布	M ガ
和 采访	M 蹦X
和 采集	M 蹦栋
和 采矿	M 蹦q
和 采取	M 蹦
和 采用	M 蹦ノ
和 采	M 蹦
和 餐饮部	M \都场
和 测试	M 代刚
和 插秧	M 础
和 超额	M WB
和 城市	M 哎
和 成千上万	M ΘdWU
和 出版社	M X┆
和 出版者	M X┆
和 出版自由	M X│邾
和 出版	M X
和 出差	M Xt
和 出发点	M XoI
和 出口贸易	M XfT
和 出口商	M Xf坝
和 出口	M Xf
和 出纳员	M X黔
和 出色	M X
和 出外	M X~
和 出席	M Xu
和 出现	M X{
和 出	M X
和 串	M 
和 大家	M ja
和 当家作主	M 讽a@D
和 当年	M 讽~
和 定额	M wB
和 斗殴	M 矮嫁
和 斗争	M 矮
和 缎	M v
和 额	M B
和 发表	M o
和 发布	M oガ
和 发达	M oF
和 发电厂	M oqt
和 发电	M oq
和 发动机	M o笆诀
和 发动	M o笆
和 发放	M o
和 发挥作用	M o揣@ノ
和 发挥	M o揣
和 发掘	M o备
和 发明家	M oa
和 发明	M o
和 发起	M o_
和 发烧	M oN
和 发生	M oネ
和 发现	M o{
和 发信	M oH
和 发行	M o
和 发言权	M oēv
和 发育	M o|
和 发展	M oi
和 发	M o
和 反共	M は@
和 分析家	M だRa
和 奋斗	M 灸矮
和 丰	M 伦
和 风格	M 樊
和 扶持	M н
和 扶	M н
和 盖板	M \O
和 哥伦比亚	M 舡郅瘿
和 歌仔戏	M qJ栏
和 格林	M 妾L
和 格	M 
和 公报	M そ厨
和 公布	M そガ
和 公共工程	M そ@u{
和 公共汽车	M そ@Tó
和 公共	M そ@
和 公仆	M そ共
和 共产党员	M @玻囊
和 共产党	M @玻囊
和 共产主义	M @玻Dq
和 共和党	M @M囊
和 共和国	M @M瓣
和 共青团	M @C刮
和 共生	M @ネ
和 共识	M @醚
和 共同努力	M @PVO
和 共同生活	M @Pネ
和 共同	M @P
和 共	M @
和 国家预算	M 瓣aw衡
和 国家	M 瓣a
和 果树	M G攫
和 焊接	M k钡
和 航海家	M 璁a
和 和平共处	M Mキ@B
和 化妆品	M てЗ~
和 黄海	M 独
和 挥发	M 揣o
和 婚姻	M B
和 迹	M 格
和 汲	M V
和 技术人员	M мNH
和 技术援助	M мN穿U
和 技术	M мN
和 家长	M a
和 家人	M aH
和 家属	M a妮
和 家庭教育	M ax毙|
和 家庭温暖	M ax放x
和 家庭	M ax
和 家务	M a叭
和 家乡	M am
和 家	M a
和 价格	M 基
和 坚持	M 绊
和 坚定	M 绊w
和 坚决	M 绊M
和 坚韧不拔	M 绊洞ぃ┺
和 坚	M 绊
和 江苏	M 磕
和 教育家	M 毙|a
和 阶级斗争	M 顶虐
和 杰出	M 城X
和 解释	M 秆睦
和 金额	M 髅B
和 紧张	M 候i
和 进出口商	M iXf坝
和 进出口业	M iXf~
和 经济学家	M g蕾厩a
和 敬意	M qN
和 敬	M q
和 酒家	M sa
和 局部地区	M Ы场a跋
和 局部	M Ы场
和 剧作家	M @@a
和 喀布尔	M 池ガ焊
和 开发	M }o
和 刊出	M ZX
和 课题	M 揭D
和 苦恼	M Wo
和 快板	M еO
和 喇嘛教	M 斥估毙
和 里昂	M 僵
和 疗养院	M 励i|
和 列宁格勒	M C圭姘
和 楼房	M 加┬
和 漏洞	M |}
和 伦敦	M 鄞
和 妈妈	M 洱洱
和 马术	M 皑N
和 美术	M N
和 面额	M 泵B
和 民族学	M チ壁厩
和 明显	M 陪
和 拿出	M 偿X
和 奶瓶	M イ~
和 恼怒	M o
和 能工巧匠	M 啶uォK
和 配额	M tB
和 佩	M ㄘ
和 批发商	M уo坝
和 批发	M уo
和 品格	M ~
和 乒乓球	M モャy
和 婆婆家	M CCa
和 扑	M 汲
和 瀑布	M rガ
和 企业家	M ~a
和 启发	M 币o
和 千千万万	M ddUU
和 千万	M dU
和 签署	M 帽p
和 签约	M 帽
和 签字	M 帽r
和 签	M 帽
和 潜能	M 肩
和 潜水艇	M 肩舾
和 钦佩	M 窜ㄘ
和 亲戚	M 克杯
和 情况	M 薄p
和 秋	M 
和 全家	M a
和 人格	M H
和 塞浦路斯	M 峨隔吹
和 桑树	M 峋
和 生活状况	M ネ―p
和 生态学家	M ネA厩a
和 输出	M 块X
和 树立	M 攫ミ
和 树脂	M 攫
和 树	M 攫
和 数额	M 计B
和 思想斗争	M 浞Q矮
和 苏联	M 默p
和 苏维埃	M 默蝴J
和 苏	M 默
和 宿舍	M J
和 桃树	M 缇
和 特殊	M S
和 提出	M 矗X
和 挑战	M D驹
和 突出	M 馥X
和 涂料	M 额
和 涂抹	M 额┵
和 托管	M Λ恨
和 托	M Λ
和 外出	M ~X
和 外交家	M ~ユa
和 外科手术	M ~欷獬N
和 挽救	M 颈
和 晚秋	M 边
和 万无一失	M UL@ア
和 万	M U
和 违法	M Hk
和 违反	M Hは
和 文章	M ゅ彻
和 武术	M ZN
和 西藏	M 杪
和 西欧国家	M 杓诎戤a
和 现阶段	M {顶q
和 限额	M B
和 新婚	M sB
和 宣布	M 钮
和 学术交流	M 厩Nユy
和 学术界	M 厩N
和 学术	M 厩N
和 熏	M 饫
和 亚洲开发银行	M ㄈw}o蝗
和 盐田	M Qバ
和 严格	M Y
和 演出	M tX
和 医疗保健	M 洛励O胺
和 医疗设备	M 洛励]称
和 医疗	M 洛励
和 遗迹	M 框格
和 移植	M 簿从
和 艺术院	M 美N|
和 艺术	M 美N
和 意识	M N醚
和 英格兰	M ^婺
和 有限	M Τ
和 有线电视	M Τuq跌
和 预测	M w代
和 战斗机	M 驹矮诀
和 战斗力	M 驹矮O
和 战斗	M 驹矮
和 战术	M 驹N
和 张家口	M iaf
和 诊疗	M E励
和 政治家	M Fva
和 政治体制	M Fv砰
和 支出	M やX
和 指出	M X
和 纸板	M 泉O
和 治疗	M v励
和 中华人民共和国	M い地Hチ@M瓣
和 主席团	M Du刮
和 主席	M Du
和 注意事项	M `Nㄆ兜
和 专家	M Ma
和 专门委员会	M Me|
和 专门	M M
和 妆扮	M Зш
和 状况	M p
和 自发	M 鄣o
和 总公司	M `そq
和 尊敬	M Lq
和 作出	M @X
和 作家	M @a
和 珀	M 
何 家	 a
合 并	X }
合 规格	X W
合 胶布	X 溅ガ
合 苏	X 默
河 采访	e 蹦X
河 堤	e 出
赫 布	划 ガ
鹤 发	b o
贺 婚	P B
贺 坚定	P 绊w
贺 敬	P q
黑 布	堵 ガ
黑 发	堵 o
黑 格	堵 
黑 颈	堵 V
很 扁长	 螵
很 出色	 X
很 出众	 X渤
很 发达	 oF
很 丰	 伦
很 坚定	 绊w
很 紧张	 候i
很 明显	 陪
很 默契	 q
很 平常	 キ`
很 融洽	 磕
很 突出	 馥X
很 有希望	 Τ票
很 有限	 Τ
亨 默	 q
衡 状况	颗 p
恒 丰	 伦
轰 出来	F Xㄓ
虹 出生	i Xネ
鸿 发	E o
洪 家	x a
洪 漫	x 憨
宏 树	Щ 攫
弘 挑战	グ D驹
红 果树	 G攫
红 帽子	 Ul
喉 切除术	筹 ち埃N
侯 树	J 攫
厚 雕像	p J钩
厚 钢板	p 葵O
后 巴格达	 ぺ婀F
后 爆发	 zo
后 背	 I
后 采取	 蹦
后 撤出	 MX
后 出动	 X笆
后 出口	 Xf
后 出现	 X{
后 出	 X
后 当年	 讽~
后 斗争	 矮
后 发表	 o
后 发出	 oX
后 发声	 on
后 发生	 oネ
后 发现	 o{
后 发展	 oi
后 发	 o
后 公布	 そガ
后 共	 @
后 国家	 瓣a
后 回家	 ^a
后 甲板	 ヒO
后 坚持	 绊
后 阶段	 顶q
后 颈部	 V场
后 签署	 帽p
后 签	 帽
后 受雇	 侗
后 树	 攫
后 苏联	 默p
后 苏	 默
后 提出	 矗X
后 西藏	 杪
后 宣布	 钮
后 演出	 tX
后 医疗	 洛励
后 有意识	 ΤN醚
后 指出	 X
后 专门	 M
后 作出	 @X
呼 伦	I 
胡 家	J a
胡 万	J U
胡 演奏家	J t诞a
湖 堤	打 出
湖 沟渠	打 肪措
湖 国家	打 瓣a
湖 开发	打 }o
湖 提出	打 矗X
弧 焊	┓ k
虎 斗	 矮
虎 足迹	 ì格
护 堤	@ 出
护 发生	@ oネ
护 树	@ 攫
互 敬	が q
沪 出境	涵 X挂
户 城市	め 哎
户 大家	め ja
户 发放	め o
户 发展	め oi
户 发	め o
户 扶	め н
户 共	め @
户 家庭	め ax
户 家	め a
户 帽子	め Ul
户 农家	め Aa
户 批发	め уo
户 签	め 帽
户 情况	め 薄p
户 万	め U
花 杯	 M
花 格	 
花 公家	 そa
花 国家	 瓣a
花 散发	 床o
华 背	地 I
华 并	地 }
华 采访	地 蹦X
华 出版社	地 X┆
华 出口	地 Xf
华 出席	地 Xu
华 发现	地 o{
华 丰	地 伦
华 公共	地 そ@
华 家	地 a
华 情况	地 薄p
华 秋	地 
华 舍	地 
华 提出	地 矗X
华 托	地 Λ
华 演出	地 tX
华 指出	地 X
华 仔细	地 J灿
滑 出赛	菲 X辽
滑 出	菲 X
滑 共有	菲 @Τ
画 出来	e Xㄓ
画 出	e X
画 风格	e 樊
画 艺术家	e 美Na
画 艺术品	e 美N~
划 出	购 X
化 布	て ガ
化 城市	て 哎
化 出口商	て Xf坝
化 出口	て Xf
化 发展	て oi
化 扶	て н
化 共同	て @P
化 技术	て мN
化 价格	て 基
化 疗	て 励
化 手术	て もN
化 校舍	て 摘
化 政治体制	て Fv砰
话 并	杠 }
话 发表	杠 o
话 宣布	杠 钮
话 严格	杠 Y
话 指出	杠 X
淮 发表	a o
欢 树	w 攫
环 杯	吏 M
环 发	吏 o
环 指出	吏 X
还 驳斥	临 婚ジ
还 采取	临 蹦
还 采用	临 蹦ノ
还 查出	临 dX
还 抽出	临 ┾X
还 出口	临 Xf
还 出面	临 X
还 出席	临 Xu
还 出现	临 X{
还 出	临 X
还 打出	临 ゴX
还 发表声明	临 o砹n
还 发表	临 o
还 发放	临 o
还 发给	临 o倒
还 发挥	临 o揣
还 发明	临 o
还 发生	临 oネ
还 发现	临 o{
还 发行	临 o
还 发	临 o
还 丰	临 伦
还 恭敬	临 シq
还 公布	临 そガ
还 共同	临 @P
还 挤出	临 澜X
还 坚持	临 绊
还 开发	临 }o
还 明显	临 陪
还 拿出	临 偿X
还 签署	临 帽p
还 签	临 帽
还 伸出	临 X
还 实况	临 龟p
还 提出	临 矗X
还 推出	临 崩X
还 托	临 Λ
还 宣布	临 钮
还 选出	临 匡X
还 严格	临 Y
还 演出	临 tX
还 依托	临 ㄌΛ
还 引发	临 まo
还 有希望	临 Τ票
还 预测	临 w代
还 指出	临 X
还 专门	临 M
还 自发	临 鄣o
还 作出	临 @X
缓 出	w X
换 出去	传 Xh
换 出	传 X
换 发展	传 oi
换 发	传 o
换 裤子	传 壳l
换 尿布	传 Эガ
幻 风格	ほ 樊
荒 并	 }
荒 发现	 o{
黄 澄	独 坚
黄 家	独 a
黄 敬	独 q
黄 帽	独 U
黄 艺术	独 美N
晃 出生	 Xネ
辉 家	谨 a
辉 宣布	谨 钮
回 采访	^ 蹦X
回 采	^ 蹦
回 老家	^ ρa
回 母校	^ ダ
回 婆家	^ Ca
回 苏联	^ 默p
回 西藏	^ 杪
回 演出	^ tX
回 医疗	^ 洛励
惠 扶持	f н
惠 金额	f 髅B
会 颁发	| {o
会 报名	| 厨W
会 背	| I
会 并	| }
会 采取	| 蹦
会 采	| 蹦
会 撤出	| MX
会 承先启后	| ┯币
会 出口	| Xf
会 出来	| Xㄓ
会 出问题	| X拜D
会 出现	| X{
会 出资购买	| X戈潦R
会 出	| X
会 倒塌	| 硕
会 发表	| o
会 发出	| oX
会 发挥	| o揣
会 发起	| o_
会 发生	| oネ
会 发送	| oe
会 发现	| o{
会 发言人	| oēH
会 发展	| oi
会 丰	| 伦
会 公报	| そ厨
会 公布	| そガ
会 共同	| @P
会 共	| @
会 国家	| 瓣a
会 焕发	| 坟o
会 技术	| мN
会 坚决	| 绊M
会 敬	| q
会 决议草案	| M某螽
会 看出	| 荪X
会 理事会主席	| zㄆ|Du
会 明显	| 陪
会 名誉主席	| WADu
会 拿出	| 偿X
会 签署	| 帽p
会 亲笔	| 克掸
会 趋向	| 镣V
会 提出	| 矗X
会 体验	| 砰喷
会 新闻公报	| sDそ厨
会 宣布	| 钮
会 选出	| 匡X
会 演出	| tX
会 医术	| 洛N
会 艺术	| 美N
会 引发	| まo
会 指出	| X
会 主席团	| Du刮
会 主席	| Du
会 专门	| M
会 作出	| @X
汇 出生	蹲 Xネ
汇 额	蹲 B
汇 丰	蹲 伦
汇 意识	蹲 N醚
绘 出	酶 X
婚 电	B q
婚 后	B 
婚 嫁	B 儿
婚 期	B 戳
婚 丧事	B 赤ㄆ
婚 丧	B 赤
婚 生育	B ネ|
婚 生	B ネ
婚 事	B ㄆ
婚 育	B |
婚 证	B 谍
混 迹	V 格
混 技术	V мN
活 蹦	 论
活 家禽	 aV
活 树木	 攫れ
伙 采取	ル 蹦
伙 汲	ル V
伙 提出	ル 矗X
火 并	 }
火 熄灭	 憾防
获 丰	莉 伦
获 风格奖	莉 樊婕
获 国家	莉 瓣a
获 苏	莉 默
获 英格兰	莉 ^婺
或 板栗	┪ O
或 采取	┪ 蹦
或 超额	┪ WB
或 城市	┪ 哎
或 出版	┪ X
或 出差	┪ Xt
或 出口	┪ Xf
或 出	┪ X
或 发出	┪ oX
或 发动	┪ o笆
或 发明者	┪ o
或 发生	┪ oネ
或 发展	┪ oi
或 发	┪ o
或 分娩	┪ だY
或 公报	┪ そ厨
或 共同	┪ @P
或 规格	┪ W
或 国家	┪ 瓣a
或 技术	┪ мN
或 家庭	┪ ax
或 价格	┪ 基
或 坚持	┪ 绊
或 局部战争	┪ Ы场驹
或 局部	┪ Ы场
或 举家	┪ |a
或 列席	┪ Cu
或 批发价	┪ уo基
或 术	┪ N
或 特殊	┪ S
或 提出	┪ 矗X
或 天花板	┪ ぱ岐O
或 有限公司	┪ Τそq
或 治疗	┪ v励
或 中华人民共和国	┪ い地Hチ@M瓣
霍 格	N 
货 额	f B
货 发票	f o布
货 丰	f 伦
货 金额	f 髅B
货 总公司	f `そq
击 出	阑 X
击 外来	阑 ~ㄓ
基 板	膀 O
基 发表	膀 o
基 家乡	膀 am
基 苏木	膀 默れ
基 宣布	膀 钮
基 战术	膀 驹N
基 指出	膀 X
机 爆发	诀 zo
机 待发	诀 莸o
机 发电厂	诀 oqt
机 发给	诀 o倒
机 隔板	诀 jO
机 技术	诀 мN
机 阶段	诀 顶q
机 局部	诀 Ы场
机 有限公司	诀 Τそq
机 有限	诀 Τ
机 治疗	诀 v励
机 总公司	诀 `そq
积 农家	n Aa
积 树木	n 攫れ
迹 斑	格 闯
迹 般	格 
迹 报告	格 厨i
迹 报	格 厨
迹 不	格 ぃ
迹 材料	格 鳟
迹 陈列室	格 朝C
迹 成	格 Θ
迹 出现	格 X{
迹 创	格 承
迹 催	格 妒
迹 的	格 
迹 等	格 单
迹 地	格 a
迹 都	格 常
迹 多	格 h
迹 发表	格 o
迹 非常	格 D`
迹 改写	格 эg
迹 感动	格 P笆
迹 广泛	格 sx
迹 广	格 s
迹 和	格 M
迹 后	格 
迹 汇	格 蹲
迹 及	格 の
迹 加以	格 [H
迹 教育	格 毙|
迹 进行	格 i
迹 可疑	格 i好
迹 可	格 i
迹 另	格 t
迹 能	格 
迹 拍	格 ╃
迹 去	格 h
迹 却	格 o
迹 深深	格 ``
迹 是	格 O
迹 受到	格 
迹 说明	格 弧
迹 体	格 砰
迹 通过	格 qL
迹 通讯	格 qT
迹 相	格 
迹 象	格 H
迹 写	格 g
迹 宣传	格 哦
迹 巡	格 ǖ
迹 一	格 @
迹 已	格 w
迹 以后	格 H
迹 引起	格 ま_
迹 有	格 Τ
迹 于	格 _
迹 在	格 b
迹 展览	格 i凝
迹 之	格 ぇ
迹 专	格 M
迹 资料	格 戈
迹 峥	格 W
鸡 技术	蔓 мN
绩 并	Z }
绩 超出	Z WX
绩 出众	Z X渤
绩 明显	Z 陪
绩 突出	Z 馥X
绩 优异	Z u钵
吉 并	N }
吉 布	N ガ
吉 发现	N o{
吉 发	N o
吉 格	N 
吉 佩	N ㄘ
吉 秋	N 
吉 翁	N 
吉 主席	N Du
籍 发	y o
籍 专家	y Ma
籍 作家	y @a
集 出版	栋 X
集 开发	栋 }o
集 美术	栋 N
集 万	栋 U
集 学术	栋 厩N
集 已出版	栋 wX
集 指出	栋 X
及 板	の O
及 采	の 蹦
及 城市	の 哎
及 出席	の Xu
及 发展	の oi
及 奋斗	の 灸矮
及 丰	の 伦
及 公共	の そ@
及 共和党	の @M囊
及 共和	の @M
及 共同	の @P
及 国家	の 瓣a
及 婚	の B
及 火力发电	の 酩Ooq
及 技术	の мN
及 家长	の a
及 家人	の aH
及 家属	の a妮
及 家庭	の ax
及 家乡	の am
及 加工技术	の [uмN
及 经济复苏	の g蕾_默
及 开发	の }o
及 伦理	の 鄄z
及 洛阳	の ザ
及 扑灭	の 汲防
及 全家	の a
及 苏联	の 默p
及 西藏	の 杪
及 西欧国家	の 杓诎戤a
及 学术界	の 厩N
及 演出	の tX
及 医疗用品	の 洛励ノ~
及 移植	の 簿从
及 纸板	の 泉O
及 专家	の Ma
及 专门委员会	の Me|
急 国家	 瓣a
疾 疗	e 励
汲 古	V j
汲 井	V か
汲 取	V 
即 发	Y o
即 国家	Y 瓣a
即 坚定不移	Y 绊wぃ簿
即 苏联	Y 默p
即 宣布独立	Y 钮Wミ
即 中华人民共和国	Y い地Hチ@M瓣
级 驳船	 婚差
级 城市	 哎
级 出现	 X{
级 方程式	 よ{Α
级 歌唱家	 q佰a
级 隔板	 jO
级 共青团	 @C刮
级 共	 @
级 国家	 瓣a
级 技术员	 мN
级 技术	 мN
级 开发	 }o
级 美术	 N
级 批发	 уo
级 签	 帽
级 医疗	 洛励
级 专家	 Ma
挤 公共汽车	澜 そ@Tó
挤 公共	澜 そ@
几 百万吨	X κU痉
几 百万	X κU
几 串	X 
几 家居	X a~
几 家小	X ap
几 家	X a
几 千万	X dU
几 十万	X QU
几 万年	X U~
几 万人	X UH
几 万	X U
技 战术	м 驹N
季 超额	u WB
季 丰	u 伦
季 共	u @
季 家	u a
季 托	u Λ
济 苏	蕾 默
寄 布	H ガ
寄 出	H X
寄 发给	H o倒
寄 回家	H ^a
寄 托著	H Λ帝
寄 托	H Λ
记 格	O 
记 共产党员	O @玻囊
记 西藏	O 杪
既 出钱	J X窥
既 发挥	J o揣
既 丰	J 伦
既 坚持	J 绊
既 舍	J 
既 树立	J 攫ミ
既 突出	J 馥X
既 违反	J Hは
既 严格	J Y
际 发表	悔 o
际 发出	悔 oX
际 推出	悔 崩X
继 发明	~ o
继 发	~ o
继 江苏	~ 磕
继 苏联	~ 默p
纪 金额	 髅B
纪 违法	 Hk
夹 发	Ж o
家 阿	a 
家 艾	a 
家 把	a р
家 坝	a 膨
家 白	a フ
家 摆手	a \も
家 拜年	a 籀~
家 半官方	a bxよ
家 半	a b
家 办	a 快
家 帮忙	a 腊Γ
家 帮助	a 腊U
家 包括	a ]A
家 保险公司	a OIそq
家 堡	a 躇
家 宝	a _
家 报告	a 厨i
家 报刊	a 厨Z
家 报名	a 厨W
家 报社	a 厨
家 报纸	a 厨
家 北京	a _ㄊ
家 被	a Q
家 本地	a セa
家 比	a ゑ
家 变成	a 跑Θ
家 标	a 夹
家 表示	a 恁
家 濒临	a x{
家 宾馆	a 猾]
家 并	a }
家 博物馆	a 痴]
家 不到	a ぃ
家 不仅	a ぃ度
家 不	a ぃ
家 才	a ~
家 采访	a 蹦X
家 菜场	a 垫初
家 餐厅	a \U
家 参加	a 把[
家 草	a 
家 厂商	a t坝
家 厂	a t
家 唱	a 佰
家 朝	a 绰
家 城市	a 哎
家 成	a Θ
家 承包	a ┯]
家 吃饭	a Y逗
家 吃	a Y
家 冲	a R
家 崇	a R
家 出版社	a X┆
家 出口	a Xf
家 出来	a Xㄓ
家 出走	a Xǐ
家 出租汽车	a X波Tó
家 出	a X
家 除夕	a 埃i
家 储蓄	a xW
家 处理	a Bz
家 串	a 
家 从	a q
家 凑	a 搓
家 村	a 
家 达到	a F
家 打	a ゴ
家 大力支持	a jOや
家 大楼	a j加
家 大门	a j
家 大型	a j
家 大	a j
家 带	a a
家 代表	a N
家 贷款	a U蹿
家 担心	a 踞み
家 单位	a 虫
家 单	a 虫
家 当时	a 讽
家 当	a 讽
家 档案	a 郎
家 到	a 
家 道歉	a Dp
家 德国	a w瓣
家 得	a o
家 的	a 
家 灯光	a O
家 登	a n
家 等	a 单
家 邓	a H
家 底细	a ┏灿
家 底	a ┏
家 地方	a aよ
家 地上	a aW
家 地	a a
家 第一	a 材@
家 电冰箱	a qBc
家 电厂	a qt
家 电器	a q竟
家 电视	a q跌
家 电影	a qv
家 电	a q
家 店	a ┍
家 鼎	a 供
家 订	a q
家 丢	a メ
家 东	a F
家 栋	a 瓷
家 洞	a }
家 斗争	a 矮
家 豆腐	a ěG
家 豆	a ě
家 都	a 常
家 独	a W
家 度过	a 坠L
家 队	a 钉
家 对手	a 癸も
家 多	a h
家 儿童	a ㄠ担
家 发明	a o
家 发现	a o{
家 发行	a o
家 发展	a oi
家 发	a o
家 阀	a 恢
家 法国	a k瓣
家 法庭	a kx
家 范	a S
家 饭店	a 逗┍
家 饭馆	a 逗]
家 饭碗	a 逗J
家 饭桌	a 逗
家 房子	a ┬l
家 访	a X
家 纺织工业	a 悸搐u~
家 纺织品	a 悸传~
家 飞	a 
家 费	a O
家 分号	a だ腹
家 分行	a だ
家 坟	a X
家 讽刺诗	a 控敫
家 夫妇	a ひ包
家 服装	a A杆
家 父子	a 鳏l
家 富	a I
家 附近	a 
家 妇女	a 包k
家 赶	a 话
家 刚刚	a 璀
家 刚	a 
家 港	a 翠
家 高	a 蔼
家 各类	a U摸
家 各	a U
家 跟踪	a 蛤萝
家 更	a 
家 工厂	a ut
家 工程	a u{
家 工业	a u~
家 工艺品	a u美~
家 工艺	a u美
家 工	a u
家 供销	a ㄑP
家 公墓	a そ褂
家 公司	a そq
家 公	a そ
家 共同	a @P
家 共有	a @Τ
家 共	a @
家 沟	a 肪
家 购	a 潦
家 姑娘	a hQ
家 骨干	a 癌F
家 骨灰	a 癌η
家 股份公司	a 靴鳏渐q
家 挂	a 本
家 关注	a 闽`
家 关	a 闽
家 官方	a xよ
家 管理	a 恨z
家 广播	a s冀
家 国际	a 瓣悔
家 国家	a 瓣a
家 国内	a 瓣ず
家 国外	a 瓣~
家 国营	a 瓣犁
家 国	a 瓣
家 过年	a L~
家 过去	a Lh
家 过	a L
家 孩子	a 膜l
家 海洋	a v
家 海运	a B
家 函授学校	a ㄧ甭厩
家 汉堡	a ~躇
家 航空公司	a 瑾扭渐q
家 航空	a 瑾
家 和睦	a M伏
家 和	a M
家 合资	a X戈
家 合作商店	a X@坝┍
家 合作	a X@
家 河	a e
家 亨	a 
家 宏	a Щ
家 后	a 
家 湖	a 打
家 户	a め
家 华	a 地
家 画廊	a eY
家 化工	a てu
家 化妆品	a てЗ~
家 话	a 杠
家 欢迎	a w
家 欢	a w
家 环境	a 吏挂
家 还是	a 临O
家 还	a 临
家 黄	a 独
家 灰	a η
家 回收	a ^Μ
家 会员	a |
家 会	a |
家 伙	a ル
家 获得	a 莉o
家 获	a 莉
家 货主	a fD
家 基	a 膀
家 机构	a 诀c
家 机关	a 诀闽
家 机	a 诀
家 积压	a n溃
家 极力	a 伐O
家 极	a 伐
家 集体	a 栋砰
家 集团	a 栋刮
家 及时	a の
家 几	a X
家 技工	a мu
家 寄	a H
家 计算机	a p衡诀
家 继续	a ~尿
家 坚	a 绊
家 简	a 虏
家 减	a 搭
家 见	a ǎ
家 建立	a 廿
家 建设	a 爻]
家 建	a 
家 将	a N
家 奖	a 贱
家 胶鞋	a 溅c
家 交谈	a ユ酵
家 交通银行	a ユq蝗
家 角	a à
家 较	a 耕
家 接纳	a 钡
家 接受	a 钡
家 杰	a 城
家 解放	a 秆
家 解决	a 秆M
家 界	a 
家 金融	a 骺
家 今年	a さ~
家 今天	a さぱ
家 进出口贸易	a iXfT
家 进出口	a iXf
家 进行	a i
家 近	a 
家 经济	a g蕾
家 经营	a g犁
家 经	a g
家 竞争	a v
家 酒店	a s┍
家 酒楼	a s加
家 救济	a 毕蕾
家 就	a N
家 居民	a ~チ
家 居住	a ~
家 驹	a s
家 咀	a C
家 举	a |
家 聚会	a E|
家 具有	a ㄣΤ
家 距	a Z
家 俱	a 
家 军火	a x
家 骏	a @
家 开发	a }o
家 开始	a }l
家 开业	a }~
家 刊物	a Z
家 勘	a 吧
家 看到	a 莰
家 看看	a 莠
家 看上了	a 荬WF
家 看	a 
家 靠	a a
家 科	a 
家 可以	a iH
家 克服	a JA
家 客户	a 趣
家 客商	a 劝
家 口述	a fz
家 口	a f
家 跨国公司	a 阁瓣そq
家 跨国	a 阁瓣
家 亏损	a 莲l
家 困难	a x螟
家 扩展到	a Xi
家 拉起	a ┰_
家 来信	a ㄓH
家 来	a ㄓ
家 劳务	a 骋叭
家 老小	a ρp
家 老	a ρ
家 乐	a 贾
家 黎	a 兢
家 离	a 瞒
家 李	a 
家 里	a 
家 礼	a 搂
家 利润	a Q柬
家 利用	a Qノ
家 利	a Q
家 立	a ミ
家 联合企业	a pX~
家 联合	a pX
家 炼油厂	a 芬ot
家 粮食	a 鲁
家 粮	a 鲁
家 两	a ㄢ
家 聊	a 册
家 疗养院	a 励i|
家 了	a F
家 劣势	a H墩
家 岭	a 拉
家 刘	a B
家 流	a y
家 楼	a 加
家 娄	a 苞
家 路	a 隔
家 铝	a T
家 旅社	a 泉
家 旅行社	a 圈妾
家 轮船	a 近差
家 轮休	a 近ヰ
家 伦	a 
家 罗	a 霉
家 络绎不绝	a 蹈枚ぃ荡
家 马	a 皑
家 买	a R
家 麦子	a 沉l
家 卖给	a 芥倒
家 满意	a 骸N
家 贸易公司	a T訾渐q
家 煤矿	a 费q
家 没有	a SΤ
家 没	a S
家 每年	a C~
家 每	a C
家 美国	a 瓣
家 美	a 
家 门牌号码	a P腹X
家 们	a 
家 面临	a 绷{
家 妙方	a Мよ
家 灭火	a 防
家 民族	a チ壁
家 民	a チ
家 明	a 
家 名为	a W
家 名	a W
家 模	a 家
家 木材	a れ
家 牧	a 
家 拿出	a 偿X
家 内部	a ず场
家 内	a ず
家 能干	a 喾F
家 能源	a 喾
家 能	a 
家 年	a ~
家 扭转	a п锣
家 扭	a п
家 农户	a Aめ
家 农具	a Aㄣ
家 农民	a Aチ
家 农业	a A~
家 农	a A
家 女士	a kh
家 排出	a 逼X
家 炮	a 
家 跑去	a ]h
家 跑	a ]
家 泡	a w
家 配合	a tX
家 配	a t
家 批发	a уo
家 批评	a у蝶
家 贫困	a hx
家 贫	a h
家 坡	a Y
家 铺子	a Ql
家 其他	a ㄤL
家 其	a ㄤ
家 企业	a ~
家 企	a 
家 启	a 币
家 汽车工业	a Tóu~
家 汽车	a Tó
家 前进	a ei
家 前	a e
家 抢修	a m
家 桥	a 爵
家 侨	a 勾
家 亲属	a 克妮
家 亲	a 克
家 秦	a 
家 请	a 叫
家 庆祝	a y
家 区	a 跋
家 去年	a h~
家 圈	a 伴
家 全国	a 瓣
家 全民	a チ
家 全	a 
家 缺少	a 胜
家 却	a o
家 认识	a {醚
家 认为	a {
家 仍旧	a ご侣
家 仍	a ご
家 日本	a らセ
家 日	a ら
家 荣	a a
家 如今	a pさ
家 如	a p
家 三	a T
家 山	a s
家 善	a 到
家 商场	a 坝初
家 商店	a 坝┍
家 商业	a 坝~
家 商	a 坝
家 上路	a W隔
家 上	a W
家 涉外	a A~
家 设备	a ]称
家 设立	a ]ミ
家 设	a ]
家 深	a `
家 生产	a ネ玻
家 生活	a ネ
家 生	a ネ
家 省	a 
家 失火	a ア
家 施工	a Iu
家 诗词	a 钢迭
家 十	a Q
家 石	a ホ
家 时	a 
家 什	a ぐ
家 食用	a 攻
家 食	a 
家 实际上	a 龟悔W
家 实验室	a 龟喷
家 使用	a ㄏノ
家 是	a O
家 市	a カ
家 试用	a 刚ノ
家 收入	a ΜJ
家 收益率	a Μqv
家 收益	a Μq
家 首先	a 亥
家 受不了	a ぃF
家 受	a 
家 蔬菜	a 江垫
家 叔叔	a 
家 书店	a 雪
家 书家	a 旬a
家 书	a 
家 税	a |
家 顺	a 抖
家 说	a 弧
家 私营企业	a p犁~
家 司	a q
家 四处	a |B
家 四	a |
家 送	a e
家 苏联	a 默p
家 所在	a ┮b
家 所	a ┮
家 她	a o
家 塔	a 娥
家 台湾	a xW
家 台	a x
家 太	a び
家 滩	a y
家 趟	a 诫
家 特	a S
家 提出	a 矗X
家 提供	a 矗ㄑ
家 提	a 矗
家 体育服装	a 砰|A杆
家 体	a 砰
家 天下	a ぱU
家 田	a バ
家 停	a 氨
家 通过	a qL
家 同类	a P摸
家 同	a P
家 投入	a щJ
家 图书馆	a 瓜牙]
家 途中	a ~い
家 兔	a ㄟ
家 团结	a 刮挡
家 团圆	a 刮蛾
家 推广	a 崩s
家 屯	a べ
家 脱	a 叉
家 外国	a ~瓣
家 外贸	a ~T
家 外资	a ~戈
家 外	a ~
家 玩具	a 报
家 万	a U
家 违法	a Hk
家 围	a 瞅
家 为	a 
家 维修	a 蝴
家 慰问	a 饥拜
家 卫	a 矫
家 温	a 放
家 文化	a ゅて
家 文明	a ゅ
家 文学	a ゅ厩
家 屋	a 
家 无	a L
家 舞厅	a RU
家 伍	a ヮ
家 吸烟者	a l废
家 喜事	a 尺ㄆ
家 喜	a 尺
家 系	a t
家 峡	a l
家 先后	a 
家 先进	a i
家 咸	a w
家 现在	a {b
家 县	a 郡
家 陷	a 炒
家 相聚	a 刍E
家 香港	a 淮
家 乡镇	a m马
家 祥	a 不
家 巷	a 
家 橡胶	a 倔溅
家 向	a V
家 消防	a 
家 小酒店	a ps┍
家 小型	a p
家 小组	a p舱
家 校	a 
家 肖	a v
家 协会	a 蠓|
家 协同	a 螃P
家 写信	a gH
家 写	a g
家 新近	a s
家 新闻	a sD
家 新	a s
家 心	a み
家 兴办	a 砍快
家 行业	a 娣~
家 姓	a m
家 兄弟	a S
家 休息	a ヰ
家 休养	a ヰi
家 休	a ヰ
家 修建	a 撰
家 修	a 
家 需要	a 惠n
家 徐	a }
家 许	a \
家 学校	a 厩
家 学	a 厩
家 呀	a r
家 烟草	a 废
家 烟囱	a 废w
家 烟	a 废
家 研究机构	a 悒s诀c
家 研究所	a 悒s┮
家 延	a ┑
家 言	a ē
家 秧	a 
家 养病	a if
家 养	a i
家 窑	a `
家 药店	a 媚┍
家 要求	a nD
家 要	a n
家 冶金	a M
家 也	a ]
家 业务	a ~叭
家 一样	a @妓
家 一	a @
家 医疗	a 洛励
家 医药	a 洛媚
家 医院	a 洛|
家 已经	a wg
家 已	a w
家 以后	a H
家 以及	a Hの
家 以上	a HW
家 以	a H
家 艺术馆	a 美N]
家 艺术	a 美N
家 义务	a q叭
家 义	a q
家 议价	a 某基
家 议论	a 某阶
家 因此	a ]
家 银行倒闭	a 蝗姝顺
家 银行	a 蝗
家 饮料	a 都
家 尹	a え
家 引进	a まi
家 引起	a ま_
家 英	a ^
家 应用	a 莱ノ
家 应	a 莱
家 营	a 犁
家 影	a v
家 用户	a ノめ
家 优势	a u墩
家 优秀	a uq
家 优	a u
家 忧	a ~
家 尤其	a ぷㄤ
家 由	a パ
家 油井	a oか
家 有数	a Τ计
家 有	a Τ
家 友	a ね
家 又	a S
家 于	a _
家 予	a ぉ
家 娱乐	a T贾
家 与	a P
家 玉米	a ドμ
家 浴室	a D
家 预算	a w衡
家 原来	a 歙
家 愿意	a @N
家 约	a 
家 月月	a るる
家 杂	a 馒
家 在	a b
家 赞扬	a g喘
家 赞	a g
家 造成	a yΘ
家 责任	a dヴ
家 增加	a W[
家 增	a W
家 曾	a 纯
家 咋	a Q
家 债权	a 杜v
家 债务	a 杜叭
家 詹	a 糕
家 帐户	a bめ
家 照	a 酚
家 这	a o
家 珍	a 
家 真诚	a u港
家 甄	a 郝
家 诊所	a E┮
家 争	a 
家 正在	a タb
家 正	a タ
家 政府	a F┎
家 证	a 谍
家 支	a や
家 之间	a ぇ丁
家 之	a ぇ
家 织锦	a 麓A
家 织	a 麓
家 职	a 戮
家 直	a 
家 值班	a 券Z
家 只好	a un
家 只要	a un
家 只有	a uΤ
家 至今	a 埭
家 致富	a PI
家 制止	a 瞍
家 制	a 
家 中国	a い瓣
家 中美	a い
家 中外	a い~
家 中小型企业	a いp~
家 中心	a いみ
家 中型	a い
家 中学	a い厩
家 中央银行	a いァ蝗
家 中央	a いァ
家 中	a い
家 种植	a 贺从
家 种	a 贺
家 重点	a I
家 株	a 
家 朱	a Χ
家 逐	a v
家 竹	a λ
家 主人	a DH
家 主要	a Dn
家 主	a D
家 柱	a W
家 住户	a 恧
家 住	a 
家 专利	a MQ
家 专门	a M
家 专为	a M
家 专业	a M~
家 专	a M
家 转让	a 锣琵
家 赚	a 寥
家 庄	a 缠
家 卓	a 
家 资金	a 戈
家 自来水厂	a 郇婴艏t
家 自主	a 邾D
家 自	a 
家 综合性	a 侯X┦
家 综合	a 侯X
家 总部	a `场
家 总是	a `O
家 走	a ǐ
家 租赁	a 哺
家 组成	a 舱Θ
家 嘴	a L
家 最大	a 程j
家 最后	a 程
家 最佳	a 程ㄎ
家 最近	a 程
家 最主要	a 程Dn
家 最	a 程
家 做	a 暗
家 作出	a @X
家 作客	a @
家 作品	a @~
家 庵	a g
家 宕	a X
家 驷	a o
家 琪	a X
家 璇	a 姊
家 璧	a z
家 桢	a 珐
家 楹	a 翻
家 臧	a N
家 祠堂	a ò
家 祠	a 
家 禧	a H
加 逼	[ G
加 布	[ ガ
加 发现	[ o{
加 格	[ 
加 国家	[ 瓣a
加 价格	[ 基
加 考古学家	[ σj厩a
加 伦	[ 
加 罗布	[ 霉ガ
加 佩	[ ㄘ
加 世家	[ @a
加 心脏移植	[ み纽簿从
加 指出	[ X
贾 格	鸽 
贾 秋	鸽 
甲 战斗	ヒ 驹矮
价 昂贵	基 Q
价 出现	基 X{
价 签	基 帽
架 薄板	[ 痢O
架 出售	[ X扳
架 哥伦比亚	[ 舡郅瘿
架 规格	[ W
架 苏联	[ 默p
架 苏	[ 默
架 战斗轰炸机	[ 驹矮F稻
架 战斗机	[ 驹矮诀
驾 摩托车	r 集Λó
坚 白	绊 フ
坚 必	绊 ゲ
坚 参	绊 把
坚 等	绊 单
坚 哈尔滨	绊 ⒑咐
坚 和	绊 M
坚 合众国	绊 X渤瓣
坚 还	绊 临
坚 今天	绊 さぱ
坚 举例	绊 |ㄒ
坚 科	绊 
坚 强有力	绊 jΤO
坚 强	绊 j
坚 认为	绊 {
坚 日前	绊 らe
坚 胜	绊 秤
坚 说	绊 弧
坚 稳	绊 铆
坚 向来	绊 Vㄓ
坚 要求	绊 nD
坚 在	绊 b
坚 赞	绊 g
坚 指出	绊 X
坚 志	绊 в
坚 主持	绊 D
坚 最后	绊 程
坚 作为	绊 @
尖 技术	y мN
间 爆发	丁 zo
间 出版	丁 X
间 出现	丁 X{
间 发表	丁 o
间 发现	丁 o{
间 发展	丁 oi
间 格调	丁 娼
间 共	丁 @
间 技术	丁 мN
间 开发	丁 }o
间 拿出	丁 偿X
间 签署	丁 帽p
间 签	丁 帽
间 散发	丁 床o
间 收藏家	丁 Μ旅a
间 掏出	丁 鼻X
间 突出	丁 馥X
间 托儿所	丁 Λㄠ┮
间 违反	丁 Hは
间 西藏	丁 杪
间 宣布	丁 钮
间 指出	丁 X
兼 并	 }
兼 出	 X
兼 发	 o
兼 国家	 瓣a
兼 劳工部长	 骋u场
兼 苏联	 默p
兼 苏	 默
兼 宿舍	 J
肩 背	 I
肩 并	 }
肩 出现	 X{
肩 斗	 矮
肩 战斗	 驹矮
检 出	浪 X
检 技术	浪 мN
柬 撤出	Z MX
柬 战场	Z 驹初
剪 发	芭 o
剪 树枝	芭 攫K
减 发	搭 o
减 国家	搭 瓣a
减 万	搭 U
鉴 出版	懦 X
鉴 格外	懦 妤~
鉴 家	懦 a
鉴 学术	懦 厩N
见 国家	ǎ 瓣a
见 老板	ǎ ρO
见 万家灯火	ǎ UaO
件 背心	ン Iみ
件 并	ン }
件 出众	ン X渤
件 共	ン @
件 股份有限公司	ン 靴鳓抄そq
件 国家	ン 瓣a
件 焊接	ン k钡
件 合格	ン X
件 技术人员	ン мNH
件 技术	ン мN
件 家	ン a
件 进出	ン iX
件 能够	ン 喟
件 艺术品	ン 美N~
件 艺术	ン 美N
件 有限公司	ン Τそq
健 如数家珍	胺 p计a
健 提出	胺 矗X
健 指出	胺 X
剑 出	C X
剑 共	C @
剑 秋	C 
建 并	 }
建 城市	 哎
建 公共厕所	 そ@Z┮
建 国家	 瓣a
建 合格	 X
建 黑板	 堵O
建 技术	 мN
建 楼房	 加┬
建 宿舍	 J
建 提出	 矗X
建 完毕	 Ч拨
建 万	 U
建 校舍	 摘
建 专家	 Ma
建 总公司	 `そq
将 挨家挨户	N 廉a沥
将 昂然	N M
将 播放	N 冀
将 采访	N 蹦X
将 采取	N 蹦
将 采用	N 蹦ノ
将 测试	N 代刚
将 撤出	N MX
将 抽出	N ┾X
将 出版	N X
将 出场	N X初
将 出口	N Xf
将 出售	N X扳
将 出席	N Xu
将 出现	N X{
将 出	N X
将 打出	N ゴX
将 单方面	N 虫よ
将 敦促	N 窗P
将 发表	N o
将 发布	N oガ
将 发电厂	N oqt
将 发动	N o笆
将 发放	N o
将 发挥	N o揣
将 发射	N og
将 发生	N oネ
将 发行	N o
将 发展	N oi
将 丰	N 伦
将 扶	N н
将 付出	N IX
将 格	N 
将 公布	N そガ
将 公共	N そ@
将 共同	N @P
将 国家	N 瓣a
将 海伦	N 
将 画家	N ea
将 家	N a
将 坚持不懈	N 绊ぃ居
将 坚持	N 绊
将 坚定不移	N 绊wぃ簿
将 坚定	N 绊w
将 坚决	N 绊M
将 坚守	N 绊u
将 坚挺	N 绊
将 坚硬	N 绊w
将 进出口	N iXf
将 喇嘛	N 斥估
将 螺丝帽	N 脸捣U
将 明显	N 陪
将 拿出	N 偿X
将 能够	N 喟
将 签署	N 帽p
将 签	N 帽
将 全家	N a
将 苏联	N 默p
将 苏	N 默
将 提出	N 矗X
将 突出	N 馥X
将 推出	N 崩X
将 退出	N hX
将 外出	N ~X
将 万古长青	N UjC
将 无家可归	N Laik
将 武术	N ZN
将 西藏	N 杪
将 形态	N 魏A
将 宣布	N 钮
将 选出	N 匡X
将 严格	N Y
将 有限	N Τ
将 有资格	N Τ戈
将 遭受	N D
将 正式宣布	N タΑ钮
将 直布罗陀	N 渐霉
将 植树	N 从攫
将 中华人民共和国	N い地Hチ@M瓣
将 专家	N Ma
将 走出	N ǐX
将 作出	N @X
浆 技术	歼 мN
浆 有限公司	歼 Τそq
江 杯	 M
江 出版社	 X┆
江 堤	 出
江 发生	 oネ
江 格	 
江 漫	 憨
疆 采访	忙 蹦X
疆 奋斗	忙 灸矮
疆 公布	忙 そガ
疆 共产党	忙 @玻囊
疆 共和国	忙 @M瓣
疆 共	忙 @
奖 杯	贱 M
奖 并	贱 }
奖 出人意料	贱 XHN
奖 出	贱 X
奖 发票	贱 o布
奖 名额	贱 WB
奖 企业家	贱 ~a
奖 作家	贱 @a
讲 出来	量 Xㄓ
讲 出	量 X
讲 斗争	量 矮
讲 发展	量 oi
讲 风格	量 樊
讲 婚	量 B
讲 坚持	量 绊
讲 客家	量 犬a
讲 中产阶级	量 い玻顶
匠 茅	K T
交 出来	ユ Xㄓ
交 出	ユ X
交 发生	ユ oネ
交 国家	ユ 瓣a
交 总公司	ユ `そq
郊 楼房	 加┬
郊 万	 U
郊 演出	 tX
浇 出	煎 X
浇 情况	煎 薄p
浇 树	煎 攫
脚 扑	} 汲
角 共和国	à @M瓣
角 露出	à SX
角 帽	à U
缴 额	煤 B
缴 国家	煤 瓣a
缴 汇出	煤 蹲X
剿 共	断 @
教 扶	毙 н
教 国家	毙 瓣a
教 专家	毙 Ma
较 发达	耕 oF
较 丰	耕 伦
较 明显	耕 陪
较 突出	耕 馥X
较 严格	耕 Y
叫 板	s O
叫 出	s X
叫 大家	s ja
窖 杯	耽 M
揭 出	处 X
揭 帽子	处 Ul
接 板栗	钡 O
接 并	钡 }
接 出来	钡 Xㄓ
接 出	钡 X
接 发车	钡 oó
接 发	钡 o
接 回家	钡 ^a
接 技术	钡 мN
接 树木	钡 攫れ
接 树	钡 攫
接 作出	钡 @X
皆 佩	 ㄘ
皆 树	 攫
街 串	刁 
街 批发市场	刁 уoカ初
街 五光十色	刁 きQ
阶 采取	顶 蹦
截 引发	I まo
节 发表	` o
节 共	` @
节 水杯	` 舄M
节 万	` U
节 演出	` tX
桔 采摘	 蹦K
桔 当年	 讽~
桔 发	 o
桔 技术	 мN
桔 树苗	 攫]
桔 树	 攫
桔 总共	 `@
杰 采取	城 蹦
杰 回家	城 ^a
杰 坚持	城 绊
杰 如数家珍	城 p计a
杰 挺身而出	城 绩τX
杰 指出	城 X
捷 布拉格	倍 ガ┰
捷 采取	倍 蹦
捷 撤出	倍 MX
捷 发布	倍 oガ
捷 公布	倍 そガ
捷 共	倍 @
捷 国家银行	倍 瓣a蝗
捷 签署	倍 帽p
捷 苏	倍 默
捷 提出抗议	倍 矗Xк某
捷 提出	倍 矗X
捷 总共	倍 `@
洁 有限公司	间 Τそq
结 采	挡 蹦
结 出	挡 X
解 采访	秆 蹦X
解 出	秆 X
解 发言人	秆 oēH
解 国家	秆 瓣a
解 家	秆 a
解 江苏	秆 磕
解 紧张	秆 候i
解 敬	秆 q
解 苏联	秆 默p
解 苏	秆 默
姐 家	j a
界 采取	 蹦
界 出现	 X{
界 发表	 o
界 发电机	 oq诀
界 付出	 IX
界 极为	 伐
界 杰出	 城X
界 敬	 q
界 能够	 喟
界 签	 帽
界 树立	 攫ミ
界 提出	 矗X
界 专家	 Ma
借 回家	 ^a
借 艺术	 美N
介 布	ざ ガ
届 杯	 M
届 布鲁塞尔	 ガ|峨焊
届 格	 
届 国家	 瓣a
届 理事会主席	 zㄆ|Du
届 学术	 厩N
届 亚洲开发银行	 ㄈw}o蝗
届 艺术节	 美N`
届 主席	 Du
斤 价格	ょ 基
金 杯	 M
金 发	 o
金 家	 a
金 坚持	 绊
金 解释	 秆睦
金 开发	 }o
金 秋	 
金 术	 N
金 提出抗议	 矗Xк某
金 万	 U
金 宣布	 钮
金 指出	 X
今 秋	さ 
紧 逼	候 G
紧 裤腰带	候 壳ya
仅 布料	度 ガ
仅 采取	度 蹦
仅 出版	度 X
仅 发行	度 o
仅 哥伦比亚	度 舡郅瘿
仅 西藏	度 杪
仅 支出	度 やX
进 矮小	i Gp
进 出境	i X挂
进 出席	i Xu
进 地板	i aO
进 斗	i 矮
进 发	i o
进 家门	i a
进 敬	i q
进 农家	i Aa
进 万	i U
进 艺术院	i 美N|
进 状况	i p
晋 电影艺术	 qv美N
晋 签	 帽
近 百万	 κU
近 千万	 dU
近 十万	 QU
近 万人	 UH
近 万	 U
浸 技术	 мN
睛 仔细	氟 J灿
晶 格	垂 
京 采访	ㄊ 蹦X
京 出差	ㄊ Xt
京 发	ㄊ o
京 丰	ㄊ 伦
京 格	ㄊ 
京 公布	ㄊ そガ
京 家	ㄊ a
京 伦	ㄊ 
京 签署	ㄊ 帽p
京 签字	ㄊ 帽r
京 宣布	ㄊ 钮
京 演出	ㄊ tX
京 植树	ㄊ 从攫
精 采	弘 蹦
经 板门店	g O┍
经 采取	g 蹦
经 测试	g 代刚
经 查出	g dX
经 雕刻	g Jㄨ
经 发现	g o{
经 奋斗	g 灸矮
经 国家	g 瓣a
经 技术	g мN
经 解释	g 秆睦
经 开发	g }o
经 手术	g もN
经 苏州	g 默{
经 特殊	g S
经 推出	g 崩X
经 艺术家	g 美Na
经 治疗	g v励
经 专家	g Ma
经 资格	g 戈
经 仔细	g J灿
井 出来	か Xㄓ
井 发生	か oネ
井 技术	か мN
井 开发	か }o
井 况	か p
井 喷出	か QX
警 并	牡 }
警 采取	牡 蹦
警 出动	牡 X笆
警 发现	牡 o{
警 共有	牡 @Τ
警 佩	牡 ㄘ
警 西藏	牡 杪
警 足迹	牡 ì格
警 作出	牡 @X
景 扶	春 н
颈 彩色	V m
颈 和	V M
颈 鹤	V b
颈 间或	V 丁┪
颈 上	V W
颈 下	V U
颈 以下	V HU
敬 边	q 娩
敬 标	q 夹
敬 才	q ~
敬 党	q 囊
敬 德	q w
敬 的	q 
敬 地	q a
敬 对	q 癸
敬 佛	q 
敬 互爱	q がR
敬 还	q 临
敬 介绍	q ざ残
敬 久	q [
敬 老	q ρ
敬 了	q F
敬 慕	q }
敬 农	q A
敬 强调	q j秸
敬 青稞	q C\
敬 人民	q Hチ
敬 如	q p
敬 三	q T
敬 为	q 
敬 文	q ゅ
敬 先	q 
敬 贤	q 藉
敬 献给	q m倒
敬 献花	q m
敬 献	q m
敬 修	q 
敬 延	q ┑
敬 业	q ~
敬 一	q @
敬 宜	q y
敬 以	q H
敬 在	q b
敬 之	q ぇ
敬 指出	q X
敬 柱	q W
敬 梓	q 标
敬 焘	q v
镜 治疗	描 v励
径 发展	| oi
竟 流下	澈 yU
竞 发	v o
净 出口	b Xf
净 额	b B
窘 况	~ p
久 敬	[ q
灸 疗法	b 励k
九 城市	E 哎
九 发出	E oX
九 家	E a
酒 价格	s 基
酒 卖出	s 芥X
旧 格局	侣 妲
旧 西藏	侣 杪
旧 校舍	侣 摘
就 搬家	N ha
就 爆发	N zo
就 背	N I
就 逼	N G
就 采取	N 蹦
就 采用	N 蹦ノ
就 草案	N 螽
就 超额	N WB
就 撤出	N MX
就 出动	N X笆
就 出发	N Xo
就 出口	N Xf
就 出来	N Xㄓ
就 出生	N Xネ
就 出现	N X{
就 出	N X
就 打出	N ゴX
就 敦促	N 窗P
就 发表	N o
就 发出	N oX
就 发动	N o笆
就 发挥	N o揣
就 发起	N o_
就 发生	N oネ
就 发展	N oi
就 发	N o
就 风尘仆仆	N 饭泄补
就 付出	N IX
就 格外	N 妤~
就 公布	N そガ
就 共同	N @P
就 国家	N 瓣a
就 好比	N nゑ
就 回家	N ^a
就 极为	N 伐
就 坚持	N 绊
就 坚决	N 绊M
就 紧张	N 候i
就 开发	N }o
就 拉平	N ┰キ
就 离婚	N 瞒B
就 亮起	N G_
就 卖出	N 芥X
就 明显	N 陪
就 拿出	N 偿X
就 能够	N 喟
就 签署	N 帽p
就 签	N 帽
就 塞浦路斯	N 峨隔吹
就 树立	N 攫ミ
就 苏联	N 默p
就 苏	N 默
就 掏出	N 鼻X
就 提出	N 矗X
就 突出	N 馥X
就 推出	N 崩X
就 违反	N Hは
就 西藏	N 杪
就 显出	N 陪X
就 孝敬	N Уq
就 宣布	N 钮
就 意识到	N N醚
就 有希望	N Τ票
就 有限	N Τ
就 有意识	N ΤN醚
就 战术	N 驹N
就 指出	N X
就 止不住	N ゎぃ
就 走出	N ǐX
就 作出	N @X
就 咄咄逼人	N FFGH
鞠 秋	六 
居 江苏	~ 磕
居 情况	~ 薄p
居 万	~ U
菊 家	碘 a
局 颁发	Ы {o
局 采取	Ы 蹦
局 出口	Ы Xf
局 出	Ы X
局 发布	Ы oガ
局 发出	Ы oX
局 发动	Ы o笆
局 发给	Ы o倒
局 发挥	Ы o揣
局 发起	Ы o_
局 发现	Ы o{
局 发行	Ы o
局 发言人	Ы oēH
局 发展	Ы oi
局 公报	Ы そ厨
局 公布	Ы そガ
局 共有	Ы @Τ
局 共	Ы @
局 接线	Ы 钡u
局 阶段	Ы 顶q
局 敬	Ы q
局 拿出	Ы 偿X
局 签	Ы 帽
局 苏	Ы 默
局 提出	Ы 矗X
局 挑战	Ы D驹
局 万	Ы U
局 预测	Ы w代
局 指出	Ы X
局 主席	Ы Du
局 作出	Ы @X
举 发展	| oi
拒 出	┶ X
据 阿根廷	沮 讧
据 巴格达	沮 ぺ婀F
据 并	沮 }
据 布	沮 ガ
据 采	沮 蹦
据 发言人	沮 oēH
据 哥伦比亚	沮 舡郅瘿
据 公报	沮 そ厨
据 公布	沮 そガ
据 共青团	沮 @C刮
据 共同	沮 @P
据 国家	沮 瓣a
据 江苏	沮 磕
据 科学家	沮 炀钱a
据 伦敦	沮 鄞
据 佩	沮 ㄘ
据 日本共同社	沮 らセ@P
据 石油输出国组织	沮 ホo块X瓣舱麓
据 苏丹	沮 默う
据 苏联	沮 默p
据 西藏	沮 杪
据 行家	沮 娈a
据 宣布	沮 钮
据 亚洲开发银行	沮 ㄈw}o蝗
据 预测	沮 w代
据 政府发言人	沮 F┎oēH
据 专家	沮 Ma
据 总工程师	沮 `u{v
巨 铲	エ 藐
巨 匠	エ K
具 出售	ㄣ X扳
具 发送	ㄣ oe
具 风格	ㄣ 樊
具 形态	ㄣ 魏A
具 艺术	ㄣ 美N
距 巴格达	Z ぺ婀F
距 采	Z 蹦
距 顶峰	Z 郴p
距 树	Z 攫
距 苏联	Z 默p
俱 杯	 M
句 格言	y 妯
句 坚持	y 绊
剧 发展	@ oi
剧 名家	@ Wa
剧 艺术家	@ 美Na
剧 艺术	@ 美N
捐 出	 X
卷 出版	 X
觉 指出	谋 X
决 出名	M XW
决 出现	M X{
决 出	M X
决 堤	M 出
决 开发	M }o
绝 迹	荡 格
绝 伦	荡 
均 采取	А 蹦
均 采用	А 蹦ノ
均 出口	А Xf
均 出现	А X{
均 发电	А oq
均 发给	А o倒
均 发生	А oネ
均 发送	А oe
均 发育	А o|
均 发展	А oi
均 公共	А そ@
均 排出	А 逼X
均 跳出	А 铬X
均 意识	А N醚
均 支出	А やX
均 植树	А 从攫
均 作出	А @X
军 颁发	x {o
军 并	x }
军 撤出	x MX
军 出动	x X笆
军 当年	x 讽~
军 发动	x o笆
军 发起	x o_
军 发生	x oネ
军 发言人	x oēH
军 分家	x だa
军 赶出	x 话X
军 共	x @
军 家属	x a妮
军 家	x a
军 坚持	x 绊
军 坚决	x 绊M
军 杰出	x 城X
军 开发	x }o
军 疗养院	x 励i|
军 提出	x 矗X
军 西藏	x 杪
军 艺术家	x 美Na
军 战斗力	x 驹矮O
军 装甲兵	x 杆ヒL
军 作曲家	x @Ρa
君 杯	g M
君 出	g X
君 秋	g 
峻 斗争	m 矮
峻 挑战	m D驹
俊 树	T 攫
喀 喇	池 斥
卡 布	d ガ
卡 发表声明	d o砹n
卡 发生	d oネ
卡 鼓掌	d 躬x
卡 伦	d 
卡 秋	d 
卡 翁	d 
卡 宣布	d 钮
开 背	} I
开 出没	} XS
开 出	} X
开 发出	} oX
开 坚实	} 绊龟
开 配额	} tB
开 脱口而出	} 叉fτX
开 追悼会	} l饱|
凯 出席	惩 Xu
凯 发明	惩 o
刊 发表	Z o
刊 发展	Z oi
刊 专门	Z M
坎 伦	Б 
砍 树	 攫
看 发挥	 o揣
看 发生	 oネ
看 技术	 мN
看 妈妈	 洱洱
看 漫	 憨
看 扫描器	 苯y竟
看 树木	 攫れ
看 演出	 tX
康 采	d 蹦
康 指出	d X
慷 国家	B 瓣a
亢 激昂	ぎ E
考 当年	σ 讽~
考 合格	σ X
考 伦	σ 
靠 逼	a G
靠 出口	a Xf
靠 出	a X
靠 大家	a ja
靠 单方面	a 虫よ
靠 发展	a oi
靠 国家	a 瓣a
靠 黑板	a 堵O
靠 技术	a мN
靠 开发	a }o
靠 树木	a 攫れ
靠 特殊	a S
靠 艺术	a 美N
靠 亿万	a 货U
棵 果树	词 G攫
棵 树苗	词 攫]
棵 树木	词 攫れ
棵 树	词 攫
磕 碰出	W IX
科 发现	 o{
科 共同	 @P
科 伦	 
科 输出	 块X
科 托	 Λ
科 宣布	 钮
科 指出	 X
科 专家	 Ma
壳 出	催 X
壳 有限	催 Τ
可 背	i I
可 辩驳	i G婚
可 采取	i 蹦
可 采	i 蹦
可 出	i X
可 大家	i ja
可 发出	i oX
可 发给	i o倒
可 发挥	i o揣
可 发下	i oU
可 发展	i oi
可 发	i o
可 国家	i 瓣a
可 开采	i }蹦
可 开发	i }o
可 看出	i 荪X
可 卖出	i 芥X
可 明显	i 陪
可 佩	i ㄘ
可 扑灭	i 汲防
可 千万	i dU
可 提出	i 矗X
可 吐出	i RX
可 挽救	i 颈
可 一家人	i @aH
可 植树	i 从攫
可 作出	i @X
克 布拉格	J ガ┰
克 布	J ガ
克 采取	J 蹦
克 出席	J Xu
克 出	J X
克 格	J 
克 共产党	J @玻囊
克 共和国	J @M瓣
克 国家银行	J 瓣a蝗
克 家	J a
克 解释	J 秆睦
克 伦	J 
克 签	J 帽
克 苏	J 默
克 提出抗议	J 矗Xк某
克 提出	J 矗X
克 托	J Λ
克 宣布	J 钮
克 指出	J X
克 主席	J Du
克 作出	J @X
刻 家	ㄨ a
刻 艺术	ㄨ 美N
垦 进出口	玖 iXf
垦 开发	玖 }o
坑 采	| 蹦
恐 共	 @
控 技术	北 мN
抠 出来	徉 Xㄓ
抠 出	徉 X
口 布置	f ガm
口 城市	f 哎
口 打出	f ゴX
口 发展	f oi
口 扶	f н
口 浮雕	f BJ
口 开发	f }o
扣 发工资	Ι ou戈
扣 发	Ι o
寇 家	F a
枯 树枝	\ 攫K
枯 树	\ 攫
哭 妈妈	 洱洱
苦 斗争	W 矮
苦 奋斗	W 灸矮
库 报名	w 厨W
库 出	w X
库 发生	w oネ
库 苏	w 默
库 星罗棋布	w P霉囱ガ
裤 的	壳 
裤 红	壳 
裤 去	壳 h
裤 上	壳 W
裤 新	壳 s
垮 出	 X
跨 出	阁 X
块 板	遏 O
块 盖板	遏 \O
块 黑板	遏 堵O
块 控制板	遏 北瞠O
块 玩耍	遏 杯A
块 艺术	遏 美N
快 颁发	е {o
快 采取	е 蹦
快 撤出	е MX
快 出现	е X{
快 出	е X
快 发展	е oi
快 扶植	е н从
快 回家	е ^a
快 拿出	е 偿X
快 能够	е 喟
快 扑灭	е 汲防
快 签署	е 帽p
快 签	е 帽
快 认出	е {X
快 提出	е 矗X
快 研究出	е 悒sX
快 走出	е ǐX
快 作出反应	е @Xは莱
快 作出	е @X
宽 出口	e Xf
宽 出席	e Xu
款 出境	蹿 X挂
款 发放	蹿 o
款 分发	蹿 だo
款 扶持	蹿 н
款 扶植	蹿 н从
款 数额	蹿 计B
匡 扶	J н
矿 采	q 蹦
矿 发动	q o笆
矿 共	q @
矿 焕发	q 坟o
矿 开发	q }o
矿 预测	q w代
况 不太	p ぃび
况 及	p の
况 说服	p 弧A
况 速	p t
奎 家	 a
魁 解释	豁 秆睦
昆 主席	 Du
拉 杯	┰ M
拉 并	┰ }
拉 布	┰ ガ
拉 采访	┰ 蹦X
拉 出发	┰ Xo
拉 发表	┰ o
拉 发出	┰ oX
拉 发电机	┰ oq诀
拉 发生	┰ oネ
拉 发展	┰ oi
拉 发	┰ o
拉 格	┰ 
拉 共同	┰ @P
拉 国家	┰ 瓣a
拉 家常	┰ a`
拉 家	┰ a
拉 提出	┰ 矗X
拉 托	┰ Λ
拉 指出	┰ X
喇 昆	斥 
喇 沁	斥 G
莱 昂	弟 
莱 伦	弟 
莱 舍	弟 
来 采访	ㄓ 蹦X
来 采购	ㄓ 蹦潦
来 采用	ㄓ 蹦ノ
来 澄清	ㄓ 坚M
来 出版	ㄓ X
来 出生	ㄓ Xネ
来 出席	ㄓ Xu
来 出现	ㄓ X{
来 出	ㄓ X
来 敦促	ㄓ 窗P
来 发表	ㄓ o
来 发放	ㄓ o
来 发挥	ㄓ o揣
来 发生	ㄓ oネ
来 发现	ㄓ o{
来 发展	ㄓ oi
来 发	ㄓ o
来 饭菜	ㄓ 逗垫
来 共同	ㄓ @P
来 共有	ㄓ @Τ
来 共	ㄓ @
来 国家	ㄓ 瓣a
来 激发	ㄓ Eo
来 技术人员	ㄓ мNH
来 技术	ㄓ мN
来 家	ㄓ a
来 坚持不懈	ㄓ 绊ぃ居
来 坚持	ㄓ 绊
来 降雨量	ㄓ 矮Bq
来 解释	ㄓ 秆睦
来 敬佩	ㄓ qㄘ
来 开发	ㄓ }o
来 列席	ㄓ Cu
来 默默	ㄓ qq
来 拍板	ㄓ ╃O
来 签署	ㄓ 帽p
来 签	ㄓ 帽
来 情况	ㄓ 薄p
来 苏联	ㄓ 默p
来 苏	ㄓ 默
来 万人	ㄓ UH
来 西藏	ㄓ 杪
来 学术	ㄓ 厩N
来 预测	ㄓ w代
来 植树	ㄓ 从攫
来 指出	ㄓ X
来 治疗	ㄓ v励
来 总工程师	ㄓ `u{v
赖 当年	苦 讽~
赖 家	苦 a
蓝 裤	屡 壳
栏 当年	逆 讽~
兰 布	孽 ガ
兰 发生	孽 oネ
兰 格	孽 
兰 共和国	孽 @M瓣
兰 共同	孽 @P
兰 国家	孽 瓣a
兰 家	孽 a
兰 裤	孽 壳
兰 树	孽 攫
兰 说出	孽 弧X
兰 苏醒	孽 默眶
兰 艺术品	孽 美N~
兰 走出	孽 ǐX
揽 苏联	朋 默p
览 万家灯火	凝 UaO
缆 布	l ガ
缆 共有	l @Τ
滥 采	垒 蹦
滥 发工资	垒 ou戈
滥 发	垒 o
琅 杯	w M
狼 共	T @
廊 发	Y o
朗 发表	 o
朗 格	 
朗 伦	 
朗 指出	 X
浪 搏斗	 i矮
劳 共和国	骋 @M瓣
劳 伦	骋 
牢 树立	c 攫ミ
老 城市	ρ 哎
老 出毛病	ρ Xをf
老 扶	ρ н
老 革命家	ρ 博Ra
老 格局	ρ 妲
老 共产党员	ρ @玻囊
老 画家	ρ ea
老 槐树	ρ i攫
老 坚持不懈	ρ 绊ぃ居
老 教育家	ρ 毙|a
老 敬	ρ q
老 喇嘛	ρ 斥估
老 妈妈	ρ 洱洱
老 梅树	ρ 宾攫
老 舍	ρ 
老 树	ρ 攫
老 邢	ρ ǚ
老 艺术家	ρ 美Na
老 政治家	ρ Fva
老 专家	ρ Ma
老 作家	ρ @a
涝 秋	妩 
勒 布	扒 ガ
勒 格	扒 
勒 签署	扒 帽p
勒 实行宵禁	扒 龟娈dT
勒 苏	扒 默
勒 托	扒 Λ
勒 指出	扒 X
勒 主席	扒 Du
乐 杯	贾 M
乐 万	贾 U
雷 出席	p Xu
雷 发表声明	p o砹n
雷 格	p 
雷 默	p q
雷 托	p Λ
雷 指出	p X
磊 托	U Λ
累 并	仓 }
累 额	仓 B
累 发展	仓 oi
累 共	仓 @
累 默默	仓 qq
累 乒乓球	仓 モャy
累 签署	仓 帽p
类 出口	摸 Xf
类 雕塑	摸 J鹅
类 丰	摸 伦
类 共享	摸 @ㄉ
类 共	摸 @
类 国家	摸 瓣a
类 能够	摸 喟
类 情况	摸 薄p
类 治疗	摸 v励
泪 扑	\ 汲
楞 板	帆 O
梨 树	冰 攫
黎 共	兢 @
离 采	瞒 蹦
离 家	瞒 a
离 苏	瞒 默
离 弦	瞒 ┒
离 演出	瞒 tX
理 出	z X
理 发	z o
理 疗法	z 励k
理 疗	z 励
理 佩	z ㄘ
理 提出	z 矗X
理 植树节	z 从攫`
理 治疗	z v励
李 发	 o
李 家	 a
李 敬	 q
李 老板	 ρO
李 默然	 qM
李 默	 q
李 秋	 
李 苏	 默
李 万	 U
李 溪	 匪
李 主席	 Du
里 报名	 厨W
里 杯	 M
里 并	 }
里 布	 ガ
里 采访	 蹦X
里 采纳	 蹦
里 采取	 蹦
里 采	 蹦
里 撤出	 MX
里 抽出	 ┾X
里 出产	 X玻
里 出来	 Xㄓ
里 出面	 X
里 出售	 X扳
里 出土	 Xg
里 出席	 Xu
里 出现	 X{
里 出	 X
里 串	 
里 发表声明	 o砹n
里 发表	 o
里 发布	 oガ
里 发出	 oX
里 发达	 oF
里 发挥	 o揣
里 发生	 oネ
里 发往	 o┕
里 发现	 o{
里 发展	 oi
里 发	 o
里 饭菜	 逗垫
里 扶植	 н从
里 腹部	 浮场
里 格	 
里 公布	 そガ
里 共	 @
里 滚出	 uX
里 糊涂	 k额
里 技术	 мN
里 家具	 aㄣ
里 家庭	 ax
里 家	 a
里 坚持	 绊
里 漫步	 憨B
里 默	 q
里 拿出	 偿X
里 恼人	 oH
里 佩	 ㄘ
里 签署	 帽p
里 签字	 帽r
里 签	 帽
里 秋收	 瞀
里 取出	 X
里 全家	 a
里 散发	 床o
里 生出	 ネX
里 树	 攫
里 掏出	 鼻X
里 提出	 矗X
里 体验	 砰喷
里 托著	 Λ帝
里 玩耍	 杯A
里 万	 U
里 问问	 拜拜
里 翁	 
里 行家	 娈a
里 宣布	 钮
里 映出	 MX
里 遭受	 D
里 蒸蒸日上	 ]]らW
里 之外	 ぇ~
里 植树	 从攫
里 指出	 X
里 种树	 贺攫
里 专门	 M
里 走出	 ǐX
里 做文章	 暗ゅ彻
里 作出	 @X
礼 出嫁	搂 X儿
礼 亲笔	搂 克掸
丽 舍	R 
利 昂	Q 
利 百万	Q κU
利 并	Q }
利 超额	Q WB
利 格	Q 
利 坚	Q 绊
利 开发	Q }o
利 佩	Q ㄘ
利 作出	Q @X
例 采用	ㄒ 蹦ノ
例 痴呆	ㄒ 扶b
例 发生	ㄒ oネ
例 发展	ㄒ oi
例 手术	ㄒ もN
例 违反	ㄒ Hは
例 指出	ㄒ X
力 并	O }
力 搏斗	O i矮
力 出发	O Xo
力 出席	O Xu
力 出	O X
力 格	O 
力 共	O @
力 技术	O мN
力 紧张	O 候i
力 能够	O 喟
力 扑	O 汲
力 托著	O Λ帝
俩 并	 }
俩 发生	 oネ
俩 技术	 мN
俩 结婚	 挡B
联 采取	p 蹦
联 出版	p X
联 公布	p そガ
联 共有	p @Τ
联 共	p @
联 坚持	p 绊
联 酒家	p sa
联 名誉主席	p WADu
联 提出	p 矗X
联 有限公司	p Τそq
联 主席	p Du
联 作出	p @X
莲 杯	浆 M
莲 拿出	浆 偿X
连 出色	s X
连 出	s X
连 发	s o
连 树木	s 攫れ
连 宿舍	s J
连 万	s U
连 西藏	s 杪
连 植树	s 从攫
连 自家	s 郛a
廉 提出	G 矗X
帘 布	┅ ガ
脸 涂	y 额
链 板机	渺 O诀
链 出现	渺 X{
链 斗	渺 矮
恋 家庭	攀 ax
炼 出	芬 X
粮 并	鲁 }
粮 出发	鲁 Xo
粮 出现	鲁 X{
粮 丰	鲁 伦
粮 农家	鲁 Aa
粮 状况	鲁 p
梁 采用	辩 蹦ノ
梁 发现	辩 o{
梁 焊接	辩 k钡
梁 坚	辩 绊
梁 树	辩 攫
梁 指出	辩 X
良 并	} }
良 发现	} o{
良 拿出	} 偿X
良 提出	} 矗X
两 百万	ㄢ κU
两 杯	ㄢ M
两 串	ㄢ 
两 共和国	ㄢ @M瓣
两 家	ㄢ a
两 阶段	ㄢ 顶q
两 千万	ㄢ dU
两 万人	ㄢ UH
两 万	ㄢ U
两 主席	ㄢ Du
辆 板车	进 Oó
辆 背	进 I
辆 出租	进 X
辆 公共汽车	进 そ@Tó
辆 摩托车	进 集Λó
辆 苏	进 默
辆 战车	进 驹ó
辆 战斗	进 驹矮
量 搬家	q ha
量 发放	q o
量 丰	q 伦
量 扶摇直上	q нn饯W
量 共	q @
量 国家	q 瓣a
量 极为	q 伐
量 明显	q 陪
量 严格	q Y
量 作出	q @X
亮 出来	G Xㄓ
亮 出	G X
亮 家	G a
亮 罗布	G 霉ガ
聊 城市	册 哎
聊 发	册 o
聊 家常	册 a`
疗 程	励 {
疗 的	励 
疗 都	励 常
疗 毒	励 r
疗 或	励 ┪
疗 机	励 诀
疗 剂量	励 警q
疗 加	励 [
疗 科	励 
疗 设备	励 ]称
疗 时	励 
疗 效果	励 莫G
疗 效	励 
疗 以及	励 Hの
疗 影响	励 vT
疗 又	励 S
疗 诊所	励 E┮
了 阿根廷	F 讧
了 矮	F G
了 案情	F 妆
了 板	F O
了 并	F }
了 布拉格	F ガ┰
了 布鞋	F ガc
了 布置	F ガm
了 布	F ガ
了 采访	F 蹦X
了 采取	F 蹦
了 采用	F 蹦ノ
了 采	F 蹦
了 参天	F 把ぱ
了 城市	F 哎
了 成千上万	F ΘdWU
了 出版	F X
了 出港	F X翠
了 出国	F X瓣
了 出口货	F Xff
了 出口商	F Xf坝
了 出口	F Xf
了 出来	F Xㄓ
了 出路	F X隔
了 出去	F Xh
了 出人意料	F XHN
了 出入	F XJ
了 出色	F X
了 出售	F X扳
了 出席	F Xu
了 出	F X
了 大丰收	F j伦Μ
了 大家	F ja
了 带回家	F a^a
了 当家作主	F 讽a@D
了 当年	F 讽~
了 道家	F Da
了 地板	F aO
了 斗争	F 矮
了 额头	F BY
了 发愁	F oT
了 发达	F oF
了 发电机	F oq诀
了 发电	F oq
了 发给	F o倒
了 发还	F o临
了 发挥	F o揣
了 发票	F o布
了 发射	F og
了 发行	F o
了 发展	F oi
了 发	F o
了 烦恼	F 沸o
了 饭菜	F 逗垫
了 奋发图强	F 灸o瓜j
了 奋发	F 灸o
了 丰	F 伦
了 扶持	F н
了 扶	F н
了 感想	F PQ
了 哥伦比亚	F 舡郅瘿
了 格	F 
了 公共汽车	F そ@Tó
了 公共	F そ@
了 共产党员	F @玻囊
了 共产党	F @玻囊
了 共产主义	F @玻Dq
了 共和国	F @M瓣
了 共青团	F @C刮
了 共识	F @醚
了 共同	F @P
了 共	F @
了 国家	F 瓣a
了 果树	F G攫
了 焊接	F k钡
了 焊	F k
了 合格	F X
了 黑板	F 堵O
了 画家	F ea
了 化妆品	F てЗ~
了 回家	F ^a
了 婚礼	F B搂
了 婚	F B
了 极为	F 伐
了 技术管理	F мN恨z
了 技术	F мN
了 家常便饭	F a`K逗
了 家常	F a`
了 家门	F a
了 家人	F aH
了 家属	F a妮
了 家庭教育	F ax毙|
了 家庭主妇	F axD包
了 家庭	F ax
了 家乡	F am
了 家用	F aノ
了 家	F a
了 价格	F 基
了 坚持不懈	F 绊ぃ居
了 坚持	F 绊
了 坚定不移	F 绊wぃ簿
了 坚定	F 绊w
了 坚固	F 绊T
了 坚决	F 绊M
了 坚实	F 绊龟
了 建树	F 鼐
了 江苏	F 磕
了 杰出	F 城X
了 解释	F 秆睦
了 金婚	F 鞅B
了 金融界	F 骺默
了 紧张	F 候i
了 进出口	F iXf
了 进出	F iX
了 敬	F q
了 救死扶伤	F 毕骇叨
了 开采	F }蹦
了 开发	F }o
了 课堂	F 揭绑
了 列宁格勒	F C圭姘
了 伦敦	F 鄞
了 妈妈	F 洱洱
了 每况愈下	F CpUU
了 民族学	F チ壁厩
了 明显	F 陪
了 派出所	F ％X┮
了 配额	F tB
了 佩	F ㄘ
了 批发生意	F уoネN
了 乒乓球	F モャy
了 扑	F 汲
了 启发	F 币o
了 千千万万	F ddUU
了 千万	F dU
了 签字	F 帽r
了 前列腺	F eC涪
了 情况	F 薄p
了 秋	F 
了 肉类	F ψ摸
了 塞浦路斯	F 峨隔吹
了 手术室	F もN
了 手术	F もN
了 殊	F 
了 术	F N
了 树林	F 攫L
了 树苗	F 攫]
了 树木	F 攫れ
了 树	F 攫
了 水土流失	F 簸gyア
了 苏丹	F 默う
了 苏联	F 默p
了 苏	F 默
了 特殊	F S
了 挑战	F D驹
了 突出	F 馥X
了 外出	F ~X
了 万人	F UH
了 万	F U
了 违法	F Hk
了 未婚妻	F ゼBd
了 文章	F ゅ彻
了 梧桐树	F 憋渚
了 武术	F ZN
了 五颜六色	F きCせ
了 西藏	F 杪
了 现阶段	F {顶q
了 校舍	F 摘
了 新闻公报	F sDそ厨
了 心迹	F み格
了 休戚与共	F ヰ杯P@
了 宣布	F 钮
了 学术交流	F 厩Nユy
了 学术	F 厩N
了 严格	F Y
了 演出	F tX
了 秧苗	F 杯]
了 养鱼场	F i辰初
了 一连串	F @s
了 医疗	F 洛励
了 依托	F ㄌΛ
了 移植	F 簿从
了 艺术	F 美N
了 亿万	F 货U
了 意识	F N醚
了 优异	F u钵
了 遭受	F D
了 战斗	F 驹矮
了 诊疗	F E励
了 政治体制	F Fv砰
了 植树	F 从攫
了 止步	F ゎB
了 治疗	F v励
了 中华人民共和国	F い地Hチ@M瓣
了 主席台	F Dux
了 专家	F Ma
了 专门	F M
了 追悼会	F l饱|
了 追思礼拜	F l渎Й
了 自发	F 鄣o
了 自家	F 郛a
廖 伦	郭 
料 布	 ガ
料 价格	 基
料 有限公司	 Τそq
列 布	C ガ
列 城市	C 哎
列 托	C Λ
林 颁发	L {o
林 并	L }
林 采取	L 蹦
林 发动	L o笆
林 丰	L 伦
林 富翁	L I
林 格	L 
林 共	L @
林 国家	L 瓣a
林 家族	L a壁
林 家	L a
林 进出口	L iXf
林 默	L q
林 散布	L 床ガ
林 提出	L 矗X
林 外史	L ~v
林 植树	L 从攫
林 指出	L X
林 作出	L @X
磷 技术	C мN
玲 并	 }
凌 斗争	 矮
凌 树	 攫
凌 提出	 矗X
陵 摩托车	钞 集Λó
陵 植树	钞 从攫
陵 种树	钞 贺攫
岭 出身	拉 Xō
岭 发生	拉 oネ
领 大家	烩 ja
领 国家	烩 瓣a
领 回家	烩 ^a
领 技术人员	烩 мNH
领 家人	烩 aH
领 家乡	烩 am
领 全家	烩 a
领 外来	烩 ~ㄓ
领 医疗	烩 洛励
领 专家	烩 Ma
另 发	t o
令 改正	O эタ
令 退出	O hX
溜 秋	啡 
硫 技术	哺 мN
硫 开发	哺 }o
留 出	d X
留 足迹	d ì格
刘 家	B a
刘 敬	B q
刘 妈妈	B 洱洱
刘 佩	B ㄘ
刘 树	B 攫
刘 万年	B U~
刘 主席	B Du
流 城市	y 哎
流 技术	y мN
流 情况	y 薄p
流 泻出	y mX
六 城市	せ 哎
龙 杯	s M
龙 家	s a
龙 坚定	s 绊w
龙 脱口而出	s 叉fτX
龙 溪	s 匪
隆 指出	订 X
楼 背后	加 I
楼 技术	加 мN
楼 手术室	加 もN
楼 遭受	加 D
漏 出力	| XO
漏 斗	| 矮
陋 布	 ガ
卢 舍	c 
炉 技术	l мN
鲁 昂	| 
鲁 布	| ガ
鲁 发射	| og
露 国家	S 瓣a
路 杯	隔 M
路 发动攻势	隔 o笆ю墩
路 发起	隔 o_
路 发送	隔 oe
路 发现	隔 o{
路 格外	隔 妤~
路 公共汽车	隔 そ@Tó
路 共	隔 @
路 美术	隔 N
路 派出所	隔 ％X┮
路 树	隔 攫
路 血迹	隔 甯
路 艺术	隔 美N
路 造型艺术	隔 y美N
路 专门	隔 M
路 仔细	隔 J灿
禄 当年	S 讽~
禄 找出	S тX
陆 丰	嘲 伦
陆 家	嘲 a
陆 树林	嘲 攫L
陆 榕树	嘲 _攫
吕 格	f 
吕 佩	f ㄘ
吕 树	f 攫
率 并	v }
率 出现	v X{
率 发布	v oガ
率 扶摇直上	v нn饯W
率 明显	v 陪
率 医疗	v 洛励
绿 裤	厚 壳
绿 树木	厚 攫れ
绿 树	厚 攫
峦 开发	r }o
卵 发育	Z o|
卵 术	Z N
乱 采	睹 蹦
乱 斗争	睹 矮
乱 国家	睹 瓣a
乱 升格	睹 ど
乱 涂	睹 额
掠 并	卑 }
抡 板	绷 O
轮 并	近 }
轮 发电机	近 oq诀
轮 技术	近 мN
轮 摩托车	近 集Λó
轮 万	近 U
伦 巴	 ぺ
伦 贝	 ī
伦 比	 ゑ
伦 别	 O
伦 伯	 B
伦 布	 ガ
伦 出席	 Xu
伦 春	 K
伦 茨	 
伦 达	 F
伦 当选	 讽匡
伦 德	 w
伦 的	 
伦 等	 单
伦 迪	 }
伦 蒂	 甫
伦 对	 癸
伦 分别	 だO
伦 港	 翠
伦 工业	 u~
伦 和	 M
伦 及	 の
伦 继	 ~
伦 贾	 鸽
伦 将	 N
伦 教授	 毙甭
伦 今天	 さぱ
伦 经济	 g蕾
伦 科	 
伦 历任	 菌ヴ
伦 纳	 
伦 内	 ず
伦 皮	 ブ
伦 坡	 Y
伦 奇	 _
伦 琴	 ^
伦 认为	 {
伦 润	 柬
伦 萨	 履
伦 三岛	 Tq
伦 什	 ぐ
伦 是	 O
伦 市	 カ
伦 说	 弧
伦 斯	 吹
伦 特	 S
伦 同志	 Pв
伦 托	 Λ
伦 为首	 碍
伦 为	 
伦 文	 ゅ
伦 西	 
伦 遗	 框
伦 在	 b
伦 之间	 ぇ丁
伦 终	 沧
伦 州	 {
伦 珠	 ]
伦 兹	 
沦 溪	_ 匪
论 西藏	阶 杪
萝 卜	炮 R
罗 布林	霉 ガL
罗 发生	霉 oネ
罗 国家银行	霉 瓣a蝗
罗 家	霉 a
罗 伦	霉 
罗 舍	霉 
罗 苏	霉 默
罗 提出	霉 矗X
罗 托	霉 Λ
罗 指出	霉 X
罗 主席	霉 Du
裸 雕	r J
洛 出	 X
洛 格	 
洛 万	 U
络 发往	蹈 o┕
络 技术	蹈 мN
络 散发	蹈 床o
玛 格	嚎 
玛 家	嚎 a
玛 艺术	嚎 美N
马 背	皑 I
马 敦促	皑 窗P
马 格	皑 
马 共同	皑 @P
马 家	皑 a
马 伦	皑 
马 签署	皑 帽p
马 树	皑 攫
马 托	皑 Λ
马 万	皑 U
马 宣布	皑 钮
马 一下子	皑 @Ul
马 指出	皑 X
买 插秧机	R 础本
买 饭菜	R 逗垫
买 化妆品	R てЗ~
买 秋	R 
麦 当年	沉 讽~
卖 出去	芥 Xh
卖 全家	芥 a
迈 出	邻 X
满 发	骸 o
满 树	骸 攫
满 血迹	骸 甯
曼 格	耙 
曼 苏	耙 默
曼 指出	耙 X
慢 出名	C XW
慢 发展	C oi
漫 沧	憨 飞
漫 长	憨 
漫 的	憨 
漫 堤	憨 出
漫 过	憨 L
漫 话	憨 杠
漫 记	憨 O
漫 满	憨 骸
漫 入	憨 J
漫 山	憨 s
漫 水	憨 
漫 滩	憨 y
漫 天	憨 ぱ
漫 田	憨 バ
漫 湾	憨 W
漫 延	憨 ┑
漫 宜	憨 y
漫 游	憨 村
漫 中	憨 い
漫 瀚	憨 v
盲 流下	 yU
忙 扶	Γ н
忙 家务	Γ a叭
毛 发	を o
毛 家	を a
毛 裤	を 壳
毛 签署	を 帽p
毛 主席	を Du
铆 焊	g k
冒 出	_ X
帽 出现	U X{
帽 的	U 
帽 等	U 单
帽 峰	U p
帽 工业	U u~
帽 交易会	U ユ龇|
帽 生产	U ネ玻
帽 下达	U UF
帽 有限公司	U Τそq
帽 园	U 堕
貌 形态	华 魏A
贸 发展	T oi
贸 发	T o
贸 进出口	T iXf
贸 专家	T Ma
么 采取	\ 蹦
么 出	\ X
么 发展	\ oi
么 坚持	\ 绊
么 解释	\ 秆睦
么 能够	\ 喟
么 佩	\ ㄘ
么 亲戚	\ 克杯
么 情况	\ 薄p
么 树	\ 攫
么 死板	\ 邯O
么 提出	\ 矗X
么 医疗	\ 洛励
么 资格	\ 戈
枚 并	T }
枚 发展	T oi
枚 共产党	T @玻囊
枚 面值	T 杯
枚 树叶	T 攫腑
梅 尔格	宾 焊
梅 格	宾 
梅 苏	宾 默
梅 托	宾 Λ
梅 宣布	宾 钮
霉 形体	` 闻
煤 出口	费 Xf
煤 出	费 X
煤 发电厂	费 oqt
煤 发电	费 oq
煤 发送	费 oe
煤 价格	费 基
煤 开发	费 }o
煤 千万	费 dU
煤 情况	费 薄p
煤 总工程师	费 `u{v
没 出现	S X{
没 出	S X
没 发生	S oネ
没 发下	S oU
没 发展	S oi
没 回家	S ^a
没 金额	S 髅B
没 资格	S 戈
镁 能够	菱 喟
每 百万	C κU
每 采	C 蹦
每 出售	C X扳
每 发生	C oネ
每 公顷	C そ臣
每 家	C a
每 开采	C }蹦
每 十万	C QU
每 万人	C UH
美 杯	 M
美 并	 }
美 出发	 Xo
美 出口	 Xf
美 发表	 o
美 发明	 o
美 发现	 o{
美 发	 o
美 感想	 PQ
美 公布	 そガ
美 国家	 瓣a
美 化学家	 て厩a
美 经济学家	 g蕾厩a
美 决议草案	 M某螽
美 科学家	 炀钱a
美 贸易额	 T雒B
美 批发	 уo
美 签署	 帽p
美 签	 帽
美 苏	 默
美 提出	 矗X
美 违背	 HI
美 文学家	 ゅ厩a
美 宣布	 钮
美 战斗机	 驹矮诀
美 主席	 Du
门 板	 O
门 采取	 蹦
门 串	 
门 发出	 oX
门 发展	 oi
门 格	 
门 共和国	 @M瓣
门 共同努力	 @PVO
门 共同	 @P
门 技术	 мN
门 家族	 a壁
门 家	 a
门 坚持	 绊
门 提出	 矗X
门 有限公司	 Τそq
门 治疗	 v励
们 颁发	 {o
们 奔走相告	 bǐ郄i
们 并	 }
们 播放	 冀
们 驳斥	 婚ジ
们 采取	 蹦
们 采用	 蹦ノ
们 采	 蹦
们 出差	 Xt
们 出丑	 X拎
们 出口	 Xf
们 出门	 X
们 出面	 X
们 出	 X
们 敦促	 窗P
们 发出	 oX
们 发动	 o笆
们 发挥	 o揣
们 发掘	 o备
们 发觉	 o谋
们 发现	 o{
们 发展	 oi
们 发	 o
们 丰	 伦
们 扶	 н
们 格外	 妤~
们 恭敬	 シq
们 共同	 @P
们 共	 @
们 合家欢	 Xaw
们 家喻户晓	 a畴め惧
们 家	 a
们 坚持	 绊
们 颈	 V
们 敬酒	 qs
们 敬佩	 qㄘ
们 敬仰	 qヵ
们 敬重	 q
们 开采	 }蹦
们 开发	 }o
们 能够	 喟
们 启发	 币o
们 手头	 もY
们 树立	 攫ミ
们 叹为观止	 鼓捌[ゎ
们 腾出	 乃X
们 提出	 矗X
们 宣布	 钮
们 演出	 tX
们 意识到	 N醚
们 踊跃	 裤D
们 预测	 w代
们 遭受	 D
们 珍惜	 帽
们 植树	 从攫
们 指出	 X
们 自发	 鄣o
们 尊敬	 Lq
萌 发	缔 o
萌 生出	缔 ネX
蒙 格	X 
蒙 签署	X 帽p
蒙 苏	X 默
蒙 托	X Λ
盟 并	幅 }
盟 共有	幅 @Τ
盟 共	幅 @
盟 国家	幅 瓣a
盟 签署	幅 帽p
盟 提出	幅 矗X
盟 宣布	幅 钮
盟 主席团	幅 Du刮
盟 主席	幅 Du
猛 发展	r oi
猛 扑上去	r 汲Wh
孟 发现	s o{
孟 国家	s 瓣a
迷 漫	g 憨
迷 签名	g 帽W
弥 万	辣 U
米 板	μ O
米 杯	μ M
米 格	μ 
米 共	μ @
米 家	μ a
米 批发市场	μ уoカ初
米 批发	μ уo
米 跳板跳水	μ 铬O铬
米 跳板	μ 铬O
泌 背叛	c Iq
棉 背心	粗 Iみ
棉 并	粗 }
棉 出现	粗 X{
棉 技术	粗 мN
免 流露出	K ySX
免 签证	K 帽谍
面 出	 X
面 发霉	 o`
面 发展	 oi
面 发	 o
面 掏出	 鼻X
苗 出现	] X{
苗 发	] o
苗 技术	] мN
苗 家	] a
藐 视	缕 跌
秒 散发	 床o
庙 发现	q o{
妙 迹	М 格
民 昂	チ 
民 采取	チ 蹦
民 采	チ 蹦
民 打出	チ ゴX
民 当家的	チ 讽a
民 当家	チ 讽a
民 发表	チ o
民 发挥	チ o揣
民 发展	チ oi
民 奋发图强	チ 灸o瓜j
民 扶危济困	チ нM蕾x
民 共和国	チ @M瓣
民 共同努力	チ @PVO
民 共同	チ @P
民 共	チ @
民 技术员	チ мN
民 家庭	チ ax
民 坚定不移	チ 绊wぃ簿
民 敬礼	チ q搂
民 敬仰	チ qヵ
民 能够	チ 喟
民 签署	チ 帽p
民 伸出	チ X
民 树立	チ 攫ミ
民 提出	チ 矗X
民 万	チ U
民 艺术	チ 美N
民 遭受	チ D
民 诊疗室	チ E励
民 指出	チ X
民 主席	チ Du
民 仔细	チ J灿
民 尊敬	チ Lq
民 作出	チ @X
闽 开发	辉 }o
明 杯	 M
明 出席	 Xu
明 出	 X
明 斗	 矮
明 发	 o
明 伦	 
明 情况	 薄p
明 秋	 
明 手术	 もN
明 术	 N
明 溪	 匪
明 指出	 X
明 主席	 Du
鸣 农家	伙 Aa
鸣 苏	伙 默
铭 指出	皇 X
名 采	W 蹦
名 城市	W 哎
名 出色	W X
名 出生	W Xネ
名 出	W X
名 发言人	W oēH
名 非战斗人员	W D驹矮H
名 富翁	W I
名 哥伦比亚	W 舡郅瘿
名 共产党员	W @玻囊
名 共产党	W @玻囊
名 共青团	W @C刮
名 雇员	W 侗
名 国家	W 瓣a
名 果树	W G攫
名 画家	W ea
名 技术人员	W мNH
名 技术员	W мN
名 技术	W мN
名 家属	W a妮
名 杰出	W 城X
名 金融界	W 骺默
名 科技专家	W 歆薇Ma
名 科学家	W 炀钱a
名 喇嘛	W 斥估
名 美术爱好者	W NRn
名 美术	W N
名 能工巧匠	W 啶uォK
名 企业家	W ~a
名 塞浦路斯	W 峨隔吹
名 石匠	W ホK
名 死者家属	W 邯坍a妮
名 苏丹	W 默う
名 苏联	W 默p
名 托儿所	W Λㄠ┮
名 违法	W Hk
名 违反	W Hは
名 西藏	W 杪
名 行家	W 娈a
名 医疗	W 洛励
名 战斗人员	W 驹矮H
名 战斗	W 驹矮
名 政治家	W Fva
名 之外	W ぇ~
名 主席团	W Du刮
名 主席	W Du
名 专家	W Ma
名 作家	W @a
摸 出名	N XW
摸 出自	N X
摸 出	N X
模 出口	家 Xf
模 家	家 a
膜 发炎	饯 o
膜 技术	饯 мN
膜 价格	饯 基
磨 出	i X
摩 苏	集 默
摩 托	集 Λ
魔 搏斗	] i矮
末 发现	ソ o{
末 发展	ソ oi
末 发	ソ o
莫 格	馋 
莫 敬神	馋 q
默 哀	q s
默 表示	q 恁
默 博士	q 痴h
默 川	q t
默 茨	q 
默 德	q w
默 的	q 
默 等	q 单
默 迪	q }
默 递交	q 患ユ
默 顿	q y
默 多	q h
默 尔	q 焊
默 涵	q [
默 和	q M
默 还	q 临
默 将	q N
默 教授	q 毙甭
默 揭开	q 处}
默 接受	q 钡
默 结束	q 挡
默 今天	q さぱ
默 就	q N
默 拉	q ┰
默 勒	q 扒
默 里	q 
默 森	q 此
默 时	q 
默 史密斯	q vK吹
默 说	q 弧
默 斯	q 吹
默 宣布	q 钮
默 一	q @
默 伊	q レ
默 在	q b
默 总理	q `z
默 庵	q g
谋 出路	垦 X隔
谋 提出	垦 矗X
某 国家	Y 瓣a
某 技术	Y мN
某 家	Y a
某 进出口	Y iXf
亩 板栗	a O
亩 发展	a oi
亩 丰	a 伦
亩 果树	a G攫
亩 胶合板	a 溅XO
亩 明显	a 陪
亩 漆树	a 海攫
亩 杉树	a 攫
亩 树林	a 攫L
亩 水土保持	a 簸gO
亩 秧苗	a 杯]
姆 杯	i M
姆 出席	i Xu
姆 发表声明	i o砹n
姆 发表	i o
姆 格	i 
姆 佩	i ㄘ
姆 签署	i 帽p
姆 宣布	i 钮
母 树林	ダ 攫L
幕 布	辊 ガ
木 参天	れ 把ぱ
木 复苏	れ _默
木 格	れ 
木 家	れ a
木 树	れ 攫
木 托	れ Λ
目 凄凉	ヘ YD
牧 杯	 M
牧 技术	 мN
拿 发展	 oi
拿 国家	 瓣a
拿 回家	 ^a
拿 家	 a
拿 治疗	 v励
哪 出	 X
哪 家	 a
那 背	ê I
那 布	ê ガ
那 家	ê a
那 亲戚	ê 克杯
纳 并	 }
纳 布	 ガ
纳 出版	 X
纳 出赛	 X辽
纳 出席	 Xu
纳 发起	 o_
纳 格	 
纳 国家元首	 瓣aじ
纳 家乡	 am
纳 坚	 绊
纳 签署	 帽p
纳 签	 帽
纳 指出	 X
乃 国家	D 瓣a
奶 家	イ a
南 百万	n κU
南 颁发	n {o
南 布	n ガ
南 采取	n 蹦
南 采	n 蹦
南 出口	n Xf
南 出席	n Xu
南 发现	n o{
南 发展	n oi
南 丰	n 伦
南 扶	n н
南 共和国	n @M瓣
南 共	n @
南 国家	n 瓣a
南 家	n a
南 降雨	n 矮B
南 开发	n }o
南 民族学	n チ壁厩
南 乒乓球	n モャy
南 签	n 帽
南 提出	n 矗X
南 外来	n ~ㄓ
南 溪	n 匪
难 采取	螟 蹦
难 出现	螟 X{
难 发展	螟 oi
难 看出	螟 荪X
难 课题	螟 揭D
难 舍	螟 
难 走出	螟 ǐX
脑 移植	福 簿从
恼 火	o 
恼 了	o F
闹 出	x X
内 并	ず }
内 采取	ず 蹦
内 采用	ず 蹦ノ
内 朝发夕至	ず 绰oi
内 撤出	ず MX
内 城市	ず 哎
内 抽出	ず ┾X
内 出动	ず X笆
内 出售	ず X扳
内 出土	ず Xg
内 出现	ず X{
内 倒塌	ず 硕
内 地板	ず aO
内 斗争	ず 矮
内 斗	ず 矮
内 发达	ず oF
内 发挥作用	ず o揣@ノ
内 发生	ず oネ
内 发现	ず o{
内 发育	ず o|
内 发展	ず oi
内 共有	ず @Τ
内 共	ず @
内 开发	ず }o
内 陆沉	ず 嘲I
内 能够	ず 喟
内 女作家	ず k@a
内 乒乓球	ず モャy
内 扑灭	ず 汲防
内 签署	ず 帽p
内 实行宵禁	ず 龟娈dT
内 苏联	ず 默p
内 提出	ず 矗X
内 涂	ず 额
内 外来	ず ~ㄓ
内 宣布	ず 钮
内 作出	ず @X
能 背	 I
能 并	 }
能 采纳	 蹦
能 采取	 蹦
能 出口	 Xf
能 出来	 Xㄓ
能 出门	 X
能 出席	 Xu
能 出现	 X{
能 出	 X
能 打出	 ゴX
能 单方面	 虫よ
能 雕	 J
能 发财	 o]
能 发出	 oX
能 发电	 oq
能 发挥作用	 o揣@ノ
能 发挥	 o揣
能 发现	 o{
能 发展	 oi
能 丰	 伦
能 共同	 @P
能 共	 @
能 回家	 ^a
能 激发	 Eo
能 技术	 мN
能 坚持	 绊
能 解释	 秆睦
能 开发	 }o
能 看出	 荪X
能 签	 帽
能 手术	 もN
能 说出	 弧X
能 特殊	 S
能 腾出	 乃X
能 违背	 HI
能 无坚不摧	 L绊ぃR
能 一下子	 @Ul
能 意识	 N醚
能 映出	 MX
能 战斗	 驹矮
能 治疗	 v励
能 总公司	 `そq
能 作出	 @X
泥 迹	d 格
尼 采	ェ 蹦
尼 出席	ェ Xu
尼 出	ェ X
尼 发生	ェ oネ
尼 格	ェ 
尼 作出	ェ @X
拟 采访	览 蹦X
拟 采取	览 蹦
拟 出	览 X
你 铲	A 藐
你 出	A X
你 斗	A 矮
你 回家	A ^a
你 家	A a
你 妈妈	A 洱洱
你 马到成功	A 皑歃ē\
你 千万	A dU
你 全家	A a
你 梳妆打扮	A 蕨━揣
你 苏醒	A 默眶
匿 迹	拔 格
年 颁发	~ {o
年 采	~ 蹦
年 测试	~ 代刚
年 查出	~ dX
年 城市	~ 哎
年 出版	~ X
年 出口	~ Xf
年 出席	~ Xu
年 出现	~ X{
年 出	~ X
年 斗	~ 矮
年 发电	~ oq
年 发放	~ o
年 发掘	~ o备
年 发行	~ o
年 发展	~ oi
年 发	~ o
年 奋斗	~ 灸矮
年 丰	~ 伦
年 共事	~ @ㄆ
年 共有	~ @Τ
年 共	~ @
年 国家	~ 瓣a
年 价格	~ 基
年 坚持不懈	~ 绊ぃ居
年 坚持	~ 绊
年 降雨量	~ 矮Bq
年 开发	~ }o
年 马到成功	~ 皑歃ē\
年 贸易额	~ T雒B
年 明显	~ 陪
年 秋	~ 
年 提出	~ 矗X
年 突出	~ 馥X
年 销售总额	~ P扳`B
年 一下子	~ @Ul
年 遭受	~ D
年 植树	~ 从攫
念 出席	├ Xu
念 主席	├ Du
娘 发	Q o
娘 感激万分	Q PEUだ
娘 家门	Q a
娘 家	Q a
娘 解释	Q 秆睦
娘 全家	Q a
娘 托	Q Λ
聂 家	驴 a
宁 发表	圭 o
宁 共青团	圭 @C刮
宁 家	圭 a
宁 经济学家	圭 g蕾厩a
宁 签署	圭 帽p
牛 背	 I
牛 出嫁	 X儿
牛 家	 a
农 杯	A M
农 出力	A XO
农 出身	A Xō
农 出	A X
农 发现	A o{
农 发展	A oi
农 共同	A @P
农 技术员	A мN
农 露出	A SX
农 签	A 帽
农 印发	A Lo
农 支出	A やX
农 作出	A @X
弄 出	 X
弄 树	 攫
努 签署	V 帽p
女 发言人	k oēH
女 匪首	k 戥
女 共产党员	k @玻囊
女 共青团	k @C刮
女 共	k @
女 雇员	k 侗
女 焊	k k
女 家庭	k ax
女 科学家	k 炀钱a
女 排出	k 逼X
女 企业家	k ~a
女 书法家	k 血ka
女 专家	k Ma
暖 万	x U
诺 布	空 ガ
诺 出席	空 Xu
诺 指出	空 X
欧 出口	稼 Xf
欧 发展	稼 oi
欧 共	稼 @
欧 国家	稼 瓣a
欧 佩	稼 ㄘ
鸥 出场	琶 X初
藕 出口	寐 Xf
爬 出门	 X
爬 格子	 妞l
爬 树	 攫
怕 邢	┤ ǚ
拍 发	╃ o
拍 技术	╃ мN
拍 托著	╃ Λ帝
排 定名	逼 wW
排 放出	逼 癀X
排 丰	逼 伦
排 技术	逼 мN
排 挑战	逼 D驹
牌 杯	P M
牌 罚出场	P @X初
派 并	 }
派 出国	 X瓣
派 出去	 Xh
派 出	 X
派 发生	 oネ
派 丰	 伦
派 共同努力	 @PVO
派 共同研究	 @P悒s
派 共同	 @P
派 共	 @
派 技术人员	 мNH
派 技术员	 мN
派 家人	 aH
派 生出	 ネX
派 宣布	 钮
派 医疗	 洛励
派 专家	 Ma
盘 突出	L 馥X
盘 托	L Λ
乓 赛	ャ 辽
旁 树木	 攫れ
旁 树	 攫
旁 植树	 从攫
抛 出去	┻ Xh
抛 出	┻ X
炮 术	 N
跑 回家	] ^a
跑 技术	] мN
泡 移植	w 簿从
裴 家	p a
配 发电	t oq
配 发	t o
佩 戴上	ㄘ 拦W
佩 戴	ㄘ 拦
佩 到	ㄘ 
佩 德	ㄘ w
佩 的	ㄘ 
佩 等	ㄘ 单
佩 定	ㄘ w
佩 动物	ㄘ 笆
佩 尔	ㄘ 焊
佩 副	ㄘ 捌
佩 和	ㄘ M
佩 回国	ㄘ ^瓣
佩 季	ㄘ u
佩 今天	ㄘ さぱ
佩 君	ㄘ g
佩 卡	ㄘ d
佩 克	ㄘ J
佩 莱	ㄘ 弟
佩 蓝	ㄘ 屡
佩 雷	ㄘ p
佩 里	ㄘ 
佩 鲁	ㄘ |
佩 吕	ㄘ f
佩 纳	ㄘ 
佩 奇	ㄘ _
佩 去	ㄘ h
佩 认为	ㄘ {
佩 三	ㄘ T
佩 施	ㄘ I
佩 说	ㄘ 弧
佩 斯	ㄘ 吹
佩 特	ㄘ S
佩 同	ㄘ P
佩 维	ㄘ 蝴
佩 文	ㄘ ゅ
佩 西	ㄘ 
佩 希	ㄘ 
佩 弦	ㄘ ┒
佩 向	ㄘ V
佩 一	ㄘ @
佩 伊	ㄘ レ
佩 英	ㄘ ^
佩 预计	ㄘ wp
佩 云	ㄘ 冻
佩 在	ㄘ b
佩 扎	ㄘ 蚕
佩 占	ㄘ 
佩 证	ㄘ 谍
佩 主持	ㄘ D
佩 总书记	ㄘ `寻O
佩 瑛	ㄘ 冯
喷 发	Q o
喷 涂	Q 额
彭 家	^ a
彭 佩	^ ㄘ
鹏 签署	P 帽p
鹏 提出	P 矗X
鹏 指出	P X
捧 杯	狈 M
捧 出	狈 X
碰 杯	I M
批 布	у ガ
批 采购	у 蹦潦
批 撤出	у MX
批 城市	у 哎
批 出口	у Xf
批 出色	у X
批 斗	у 矮
批 非战斗人员	у D驹矮H
批 共产党员	у @玻囊
批 共	у @
批 国家	у 瓣a
批 果树	у G攫
批 焊	у k
批 技术	у мN
批 坚定	у 绊w
批 阶段	у 顶q
批 开发	у }o
批 客家	у 犬a
批 楼房	у 加┬
批 美术	у N
批 明显	у 陪
批 企业家	у ~a
批 树叶	у 攫腑
批 苏联	у 默p
批 违法	у Hk
批 校舍	у 摘
批 学术	у 厩N
批 严格	у Y
批 医疗	у 洛励
批 艺术品	у 美N~
批 有资格	у Τ戈
批 治疗	у v励
批 专家	у Ma
劈 出	A X
皮 帽	ブ U
篇 出自	g X
篇 文章	g ゅ彻
篇 学术论文	g 厩N阶ゅ
片 并	 }
片 采用	 蹦ノ
片 采	 蹦
片 丰	 伦
片 共	 @
片 欢笑	 w
片 开发	 }o
片 楼房	 加┬
片 树林	 攫L
片 树	 攫
片 移植	 簿从
片 有限公司	 Τそq
片 植树	 从攫
飘 出	钠 X
飘 到场	钠 斐
票 技术	布 мN
贫 出	h X
贫 攻坚	h ю绊
贫 开发	h }o
贫 课题	h 揭D
贫 情况	h 薄p
贫 专家	h Ma
品 采购	~ 蹦潦
品 出口贸易	~ XfT
品 出口	~ Xf
品 出	~ X
品 丰	~ 伦
品 合格	~ X
品 价格	~ 基
品 进出口	~ iXf
品 开发	~ }o
品 批发市场	~ уoカ初
品 严格	~ Y
品 有限公司	~ Τそq
品 总公司	~ `そq
聘 技术	u мN
苹 拿出	墨 偿X
平 布	キ ガ
平 出席	キ Xu
平 签名	キ 帽W
平 提出	キ 矗X
平 外出	キ ~X
平 性格	キ ┦
平 指出	キ X
凭 国家	咎 瓣a
凭 亲戚	咎 克杯
瓶 出口	~ Xf
评 并	蝶 }
评 出	蝶 X
评 国家	蝶 瓣a
评 选出	蝶 匡X
屏 打出	 ゴX
屏 指出	 X
颇 丰	会 伦
破 格	} 
迫 采取	 蹦
迫 发布	 oガ
迫 退出	 hX
迫 宣布	 钮
扑 把	汲 р
扑 出	汲 X
扑 大火	汲 j
扑 到了	汲 欷F
扑 到	汲 
扑 掉	汲 奔
扑 跪	汲 各
扑 过来	汲 Lㄓ
扑 火大	汲 酩j
扑 火	汲 
扑 进	汲 i
扑 救	汲 毕
扑 来	汲 ㄓ
扑 了	汲 F
扑 前方	汲 eよ
扑 去	汲 h
扑 上前	汲 We
扑 上	汲 W
扑 腾	汲 乃
扑 下	汲 U
扑 在	汲 b
扑 簌	汲 P
铺 板	Q O
仆 关	共 闽
仆 后继	共 崮~
普 并	炊 }
普 布	炊 ガ
普 降雨	炊 矮B
普 文章	炊 ゅ彻
浦 开发	 }o
期 出口	戳 Xf
期 发行	戳 o
期 共同努力	戳 @PVO
期 共	戳 @
期 国家	戳 瓣a
期 技术	戳 мN
期 家庭	戳 ax
期 开发	戳 }o
期 签署	戳 帽p
期 新婚夫妇	戳 sBひ包
期 预测	戳 w代
戚 部长	杯 场
戚 德	杯 w
戚 继	杯 ~
戚 丽	杯 R
戚 墅	杯 怪
戚 元	杯 じ
七 城市	C 哎
七 家	C a
凄 然	Y M
其 背景	ㄤ I春
其 别出心裁	ㄤ OXみ掉
其 出阁	ㄤ X徽
其 出口	ㄤ Xf
其 出售	ㄤ X扳
其 定名	ㄤ wW
其 发表	ㄤ o
其 发挥	ㄤ o揣
其 发生	ㄤ oネ
其 发行	ㄤ o
其 发源地	ㄤ o方a
其 发展	ㄤ oi
其 格	ㄤ 
其 共同	ㄤ @P
其 化妆品	ㄤ てЗ~
其 技术	ㄤ мN
其 家属	ㄤ a妮
其 价格	ㄤ 基
其 经济复苏	ㄤ g蕾_默
其 课题	ㄤ 揭D
其 疗	ㄤ 励
其 墨迹	ㄤ 茎格
其 皮层	ㄤ ブh
其 情况	ㄤ 薄p
其 特殊	ㄤ S
其 托管	ㄤ Λ恨
其 婉	ㄤ 胞
其 违反	ㄤ Hは
其 性格	ㄤ ┦
其 严格	ㄤ Y
其 艺术	ㄤ 美N
其 战斗力	ㄤ 驹矮O
其 治疗	ㄤ v励
其 主席	ㄤ Du
其 专门委员会	ㄤ Me|
其 追随者	ㄤ lH
其 资格	ㄤ 戈
其 作出	ㄤ @X
棋 家	囱 a
奇 并	_ }
奇 出	_ X
奇 斗	_ 矮
奇 发表声明	_ o砹n
奇 发现	_ o{
奇 风尘仆仆	_ 饭泄补
奇 迹	_ 格
奇 默默无闻	_ qqLD
奇 签署	_ 帽p
奇 提出	_ 矗X
奇 宣布	_ 钮
奇 指出	_ X
奇 主席	_ Du
齐 布	霍 ガ
齐 出现	霍 X{
齐 奋斗	霍 灸矮
齐 家	霍 a
旗 出现	X X{
旗 遭受	X D
祁 家	 a
骑 摩托车	M 集Λó
骑 术	M N
起 背包	_ I]
起 插秧	_ 础
起 出场	_ X初
起 出发	_ Xo
起 出席	_ Xu
起 发生	_ oネ
起 发行	_ o
起 发	_ o
起 丰	_ 伦
起 共产党员	_ @玻囊
起 共产主义	_ @玻Dq
起 共同	_ @P
起 共享	_ @ㄉ
起 共	_ @
起 国家	_ 瓣a
起 技术	_ мN
起 家常	_ a`
起 家庭	_ ax
起 家	_ a
起 坚持	_ 绊
起 酒杯	_ sM
起 巨额	_ エB
起 裤腿	_ 壳L
起 明显	_ 陪
起 实行宵禁	_ 龟娈dT
起 手术	_ もN
起 水桶	_ 舯
起 塌	_ 厄
起 推出	_ 崩X
起 万	_ U
起 威逼	_ 鹿G
起 严格	_ Y
起 亿万	_ 货U
起 有限公司	_ Τそq
起 战斗	_ 驹矮
起 植树	_ 从攫
器 采用	竟 蹦ノ
器 焊接	竟 k钡
器 专门	竟 M
气 背	 I
气 并	 }
气 测试	 代刚
气 发展	 oi
气 焊	 k
气 价格	 基
气 开发	 }o
气 能够	 喟
弃 家	斌 a
汽 开发	T }o
汽 提出	T 矗X
汽 总公司	T `そq
恰 卜	 R
千 百万	d κU
千 发	d o
千 公顷	d そ臣
千 家事	d aㄆ
千 家	d a
千 名家	d Wa
千 千万	d dU
千 树	d 攫
千 万人	d UH
迁 出	E X
签 的	帽 
签 定	帽 w
签 订购	帽 q潦
签 订	帽 q
签 发	帽 o
签 封	帽 
签 个	帽 
签 购买	帽 潦R
签 和	帽 M
签 合同	帽 XP
签 价目	帽 基ヘ
签 揭晓	帽 处惧
签 结果	帽 挡G
签 就是	帽 NO
签 两	帽 ㄢ
签 了	帽 F
签 内容	帽 ずe
签 批	帽 у
签 上	帽 W
签 式	帽 Α
签 收	帽 Μ
签 苏	帽 默
签 停火	帽 氨
签 统一	帽 参@
签 投篮	帽 щx
签 外	帽 ~
签 完了	帽 ЧF
签 姓名	帽 mW
签 一	帽 @
签 仪式	帽 祸Α
签 由	帽 パ
签 有	帽 Τ
签 这	帽 o
签 中国	帽 い瓣
谦 出席	辆 Xu
乾 出席	爱 Xu
乾 提出	爱 矗X
乾 宣布	爱 钮
乾 指出	爱 X
钱 出名	窥 XW
钱 额	窥 B
钱 家	窥 a
钱 拿出来	窥 偿Xㄓ
钱 树	窥 攫
钱 万	窥 U
钱 有限	窥 Τ
前 盎格鲁撒克逊人	e s婢|蓟J还H
前 颁发	e {o
前 爆发	e zo
前 并	e }
前 布置	e ガm
前 采取	e 蹦
前 撤出	e MX
前 出国	e X瓣
前 出现	e X{
前 单方面	e 虫よ
前 额	e B
前 发表	e o
前 发出	e oX
前 发动	e o笆
前 发稿	e oZ
前 发生	e oネ
前 发现	e o{
前 发展	e oi
前 发	e o
前 丰	e 伦
前 公布	e そガ
前 共和党	e @M囊
前 共和国	e @M瓣
前 共同	e @P
前 国家	e 瓣a
前 敬	e q
前 默默	e qq
前 默	e q
前 拍照	e ╃酚
前 佩	e ㄘ
前 扑	e 汲
前 仆	e 共
前 签署	e 帽p
前 提出	e 矗X
前 推出	e 崩X
前 宣布	e 钮
前 战斗	e 驹矮
前 专门	e M
潜 出	肩 X
欠 默契	ろ q
羌 出发	 Xo
强 发挥	j o揣
强 拿出	j 偿X
强 提出	j 矗X
抢 出	m X
抢 发	m o
锹 铲	陵 藐
锹 种树	陵 贺攫
敲 出	V X
桥 出口加工区	爵 Xf[u跋
桥 格外	爵 妤~
桥 指出	爵 X
乔 布	踌 ガ
乔 格	踌 
乔 鼓掌	踌 躬x
巧 当家	ォ 讽a
切 出	ち X
切 国家	ち 瓣a
且 采取	B 蹦
且 采用	B 蹦ノ
且 发挥	B o揣
且 发展	B oi
且 技术	B мN
且 价格	B 基
且 开发	B }o
且 宣布	B 钮
且 研究出	B 悒sX
且 指出	B X
亲 串	克 
亲 妈妈	克 洱洱
秦 万	 U
琴 出生	^ Xネ
琴 演奏家	^ t诞a
禽 出	V X
沁 出汗	G X
沁 出	G X
青 出席	C Xu
轻 发落	淮 o辅
轻 技术	淮 мN
轻 总公司	淮 `そq
清 板	M O
清 并	M }
清 出	M X
清 丰	M 伦
清 共同	M @P
清 国家	M 瓣a
清 拍板	M ╃O
清 情况	M 薄p
清 苏	M 默
清 小说家	M p弧a
情 并	薄 }
情 采取	薄 蹦
情 出发	薄 Xo
情 出	薄 X
情 发布	薄 oガ
情 发生	薄 oネ
情 明显	薄 陪
情 树	薄 攫
情 支出	薄 やX
请 昂	叫 
请 出示	叫 Xボ
请 大家	叫 ja
请 当年	叫 讽~
请 到家	叫 飚a
请 歌唱家	叫 q佰a
请 国家	叫 瓣a
请 技术员	叫 мN
请 解释	叫 秆睦
请 列出	叫 CX
请 签	叫 帽
请 万	叫 U
请 专家	叫 Ma
庆 采访	y 蹦X
庆 城市	y 哎
庆 出口	y Xf
庆 发	y o
庆 丰	y 伦
庆 共和国	y @M瓣
庆 家	y a
庆 金婚	y 鞅B
庆 舍	y 
庆 挺身而出	y 绩τX
庆 治疗	y v励
琼 布	茫 ガ
穷 帽子	a Ul
穷 有希望	a Τ票
秋 保	 O
秋 备	 称
秋 被	 Q
秋 并	 }
秋 播	 冀
秋 补	 干
秋 菜	 垫
秋 出现	 X{
秋 从	 q
秋 达到	 F
秋 的	 
秋 等	 单
秋 冬	 V
秋 对	 癸
秋 翻	 陆
秋 防	 
秋 副部长	 捌场
秋 副	 捌
秋 冈	 
秋 割	 澄
秋 给	 倒
秋 更	 
秋 和	 M
秋 后	 
秋 还	 临
秋 及	 の
秋 季节	 u`
秋 将	 N
秋 教	 毙
秋 解散	 秆床
秋 今天	 さぱ
秋 举行	 |
秋 开始	 }l
秋 克	 J
秋 来	 ㄓ
秋 涝	 妩
秋 里	 
秋 连	 s
秋 粮	 鲁
秋 玲	 
秋 率	 v
秋 明	 
秋 末	 ソ
秋 萍	 涤
秋 起	 _
秋 千	 d
秋 日	 ら
秋 荣	 a
秋 散文	 床ゅ
秋 莎	 诧
秋 设	 ]
秋 时节	 筛`
秋 时	 
秋 是	 O
秋 说	 弧
秋 提出	 矗X
秋 同	 P
秋 吐出	 RX
秋 委员	 e
秋 香	 
秋 向	 V
秋 验收	 喷Μ
秋 一	 @
秋 衣	 
秋 以来	 Hㄓ
秋 艺术节	 美N`
秋 艺术	 美N
秋 与	 P
秋 越	 V
秋 月头	 るY
秋 云	 冻
秋 杂粮	 馒鲁
秋 早霜	 Ν流
秋 整	 俱
秋 正	 タ
秋 之	 ぇ
秋 指出	 X
秋 种	 贺
秋 转达	 锣F
秋 最后	 程
秋 昨天	 Qぱ
秋 作物	 @
球 板	y O
球 发出	y oX
球 技术	y мN
求 出路	D X隔
求 发达	D oF
求 发展	D oi
求 共同	D @P
求 国家	D 瓣a
求 签名	D 帽W
求 鞋匠	D cK
求 艺术	D 美N
酋 发现	 o{
酋 医疗	 洛励
趋 紧张	镣 候i
区 安家落户	跋 wa辅め
区 爆发	跋 zo
区 并	跋 }
区 采访	跋 蹦X
区 采取	跋 蹦
区 采用	跋 蹦ノ
区 撤出	跋 MX
区 出口商	跋 Xf坝
区 出口	跋 Xf
区 出现	跋 X{
区 发动	跋 o笆
区 发挥	跋 o揣
区 发生	跋 oネ
区 发展	跋 oi
区 扶	跋 н
区 共同	跋 @P
区 共有	跋 @Τ
区 共	跋 @
区 国家	跋 瓣a
区 坚持	跋 绊
区 景况	跋 春p
区 开发	跋 }o
区 帽子	跋 Ul
区 鸟巢	跋 尘_
区 签	跋 帽
区 肉类	跋 ψ摸
区 苏维埃	跋 默蝴J
区 特殊	跋 S
区 提出	跋 矗X
区 突出	跋 馥X
区 脱颖而出	跋 叉oτX
区 万	跋 U
区 盐田	跋 Qバ
区 演出	跋 tX
区 艺术家	跋 美Na
区 之外	跋 ぇ~
区 植树	跋 从攫
区 状况	跋 p
区 作出	跋 @X
曲 出口	Ρ Xf
曲 格	Ρ 
曲 激昂	Ρ E
曲 艺术家	Ρ 美Na
曲 作家	Ρ @a
驱 赶出去	X 话Xh
取 城市	 哎
取 出让	 X琵
取 额外	 B~
去 巴格达	h ぺ婀F
去 板门店	h O┍
去 布拉格	h ガ┰
去 采访	h 蹦X
去 采集	h 蹦栋
去 采	h 蹦
去 搀扶	h eн
去 出售	h X扳
去 发动	h o笆
去 发展	h oi
去 扶	h н
去 格外	h 妤~
去 江苏	h 磕
去 开发	h }o
去 漫不经心	h 憨ぃgみ
去 秋	h 
去 苏联	h 默p
去 问问	h 拜拜
去 西藏	h 杪
去 演出	h tX
去 治疗	h v励
圈 出	伴 X
圈 星罗棋布	伴 P霉囱ガ
权 发生	v oネ
权 发展	v oi
权 发	v o
权 共享	v @ㄉ
权 共有	v @Τ
权 提出异议	v 矗X钵某
权 提出	v 矗X
权 意识	v N醚
泉 家	u a
泉 坚持	u 绊
泉 有限公司	u Τそq
全 出差	 Xt
全 斗	 矮
全 额	 B
全 家人	 aH
全 家祖	 a
全 拿出	 偿X
全 树	 攫
全 苏	 默
全 西藏	 杪
缺 树	 攫
缺 医疗	 洛励
却 背	o I
却 并	o }
却 出人意料	o XHN
却 出现	o X{
却 出	o X
却 发起	o o_
却 发生	o oネ
却 发现	o o{
却 发展	o oi
却 格外	o 妤~
却 价格	o 基
却 坚持	o 绊
却 坚决	o 绊M
却 坚毅	o 绊驾
却 默默	o qq
却 拿出	o 偿X
却 婉	o 胞
却 显出	o 陪X
却 宣布	o 钮
却 一下子	o @Ul
却 引出	o まX
却 遭受	o D
确 有希望	T Τ票
确 作出	T @X
群 发现	s o{
群 遗迹	s 框格
然 出来	M Xㄓ
然 退出	M hX
染 发	V o
让 出版	琵 X
让 大家	琵 ja
让 公共	琵 そ@
让 共产党	琵 @玻囊
让 国家	琵 瓣a
让 技术	琵 мN
让 家人	琵 aH
让 家属	琵 a妮
让 家	琵 a
让 价格	琵 基
让 书法家	琵 血ka
让 西藏	琵 杪
让 有限	琵 Τ
扰 国家	Z 瓣a
绕 树	露 攫
热 发	荐 o
热 解释	荐 秆睦
热 疗	荐 励
热 微分方程	荐 Lだよ{
仁 布	く ガ
仁 出席	く Xu
人 百万	H κU
人 报名	H 厨W
人 背	H I
人 并	H }
人 采取	H 蹦
人 采用	H 蹦ノ
人 崇敬	H Rq
人 出发	H Xo
人 出境	H X挂
人 出来	H Xㄓ
人 出面	H X
人 出去	H Xh
人 出生	H Xネ
人 出售	H X扳
人 出外	H X~
人 出席	H Xu
人 出现	H X{
人 出	H X
人 大发脾气	H jo凳
人 发表	H o
人 发出	H oX
人 发牢骚	H oc奶
人 发展	H oi
人 奋发向上	H 灸oVW
人 丰	H 伦
人 扶老携幼	H нρ拟ギ
人 赶出	H 话X
人 共谋	H @垦
人 共事	H @ㄆ
人 共同	H @P
人 共	H @
人 回家	H ^a
人 及格	H の
人 技术	H мN
人 家人	H aH
人 家小	H ap
人 家用	H aノ
人 家	H a
人 坚持	H 绊
人 结婚	H 挡B
人 看起来	H 莅_ㄓ
人 默不作声	H qぃ@n
人 能够	H 喟
人 佩	H ㄘ
人 签名	H 帽W
人 签署	H 帽p
人 驱逐出境	H XvX挂
人 日出	H らX
人 实业家	H 龟~a
人 术	H N
人 树立	H 攫ミ
人 提出	H 矗X
人 退出	H hX
人 托	H Λ
人 无家可归	H Laik
人 宣布	H 钮
人 选出	H 匡X
人 演出	H tX
人 医疗	H 洛励
人 移植	H 簿从
人 意识到	H N醚
人 踊跃	H 裤D
人 指出	H X
人 治疗	H v励
人 专家	H Ma
人 走出	H ǐX
人 作出反应	H @Xは莱
任 国家	ヴ 瓣a
任 家	ヴ a
任 苏联	ヴ 默p
任 提出	ヴ 矗X
任 西藏	ヴ 杪
任 主席	ヴ Du
扔 饭菜	サ 逗垫
仍 采用	ご 蹦ノ
仍 层出不穷	ご hXぃa
仍 超额	ご WB
仍 痴	ご 扶
仍 雕刻	ご Jㄨ
仍 发现	ご o{
仍 坚持不懈	ご 绊ぃ居
仍 坚持	ご 绊
仍 拿出	ご 偿X
仍 千呼万唤	ご dIU酬
仍 有希望	ご Τ票
日 并	ら }
日 布	ら ガ
日 出版	ら X
日 出口	ら Xf
日 出现	ら X{
日 发表	ら o
日 发车	ら oó
日 发出	ら oX
日 发生	ら oネ
日 发现	ら o{
日 发	ら o
日 公布	ら そガ
日 共同	ら @P
日 进出	ら iX
日 科学家	ら 炀钱a
日 疗	ら 励
日 能够	ら 喟
日 树立	ら 攫ミ
日 苏联	ら 默p
日 苏	ら 默
日 探险家	ら 贝Ia
日 提出	ら 矗X
日 宣布	ら 钮
日 指出	ら X
日 专家	ら Ma
日 作出	ら @X
荣 并	a }
荣 出生	a Xネ
荣 丰	a 伦
荣 坚持	a 绊
荣 治疗	a v励
融 艺术	磕 美N
容 并	e }
绒 布	党 ガ
肉 斗	ψ 矮
如 阿根廷	p 讧
如 昂首	p 
如 查出	p dX
如 痴	p 扶
如 当年	p 讽~
如 发达	p oF
如 发动机	p o笆诀
如 发生	p oネ
如 发现	p o{
如 归家	p ka
如 家	p a
如 马术	p 皑N
如 木雕	p れJ
如 苏打水	p 默ゴ
如 苏	p 默
如 万一	p U@
如 西藏	p 杪
如 宣布	p 钮
如 艺术	p 美N
辱 人格	d H
入 成千上万	J ΘdWU
入 出版	J X
入 出境	J X挂
入 出	J X
入 当年	J 讽~
入 国家	J 瓣a
入 画家	J ea
入 技术	J мN
入 课堂	J 揭绑
入 秋	J 
入 托	J Λ
入 外来	J ~ㄓ
入 西藏	J 杪
若 昂	Y 
若 采用	Y 蹦ノ
若 出	Y X
若 发现	Y o{
若 苏联	Y 默p
洒 出	s X
萨 布	履 ガ
萨 采	履 蹦
萨 格	履 
萨 苏	履 默
萨 提出	履 矗X
塞 尔格	峨 焊
塞 格	峨 
塞 佩	峨 ㄘ
塞 万	峨 U
赛 冰雕	辽 BJ
赛 采用	辽 蹦ノ
赛 出现	辽 X{
赛 出	辽 X
赛 格	辽 
赛 公布	辽 そガ
赛 共有	辽 @Τ
赛 共	辽 @
赛 国家	辽 瓣a
赛 阶段	辽 顶q
赛 名额	辽 WB
赛 苏	辽 默
赛 挑战	辽 D驹
赛 资格	辽 戈
三 出发	T Xo
三 大杯	T jM
三 共和国	T @M瓣
三 家	T a
三 坚持	T 绊
桑 布	 ガ
桑 格	 
桑 家	 a
桑 坚	 绊
桑 托	 Λ
嫂 树	A 攫
色 价格	 基
色 鸭舌帽	 n薮U
色 艺术	 美N
森 并	此 }
森 发明	此 o
森 坚持	此 绊
森 签署	此 帽p
森 指出	此 X
杀 国家	炳 瓣a
杀 家	炳 a
刹 婚	b B
沙 逼	F G
沙 出	F X
沙 斗争	F 矮
沙 漫漫	F 憨憨
沙 佩	F ㄘ
沙 情况	F 薄p
沙 万	F U
沙 枣树	F 辞攫
沙 专家	F Ma
纱 布	 ガ
纱 技术	 мN
山 百万	s κU
山 板栗	s O
山 杯	s M
山 背	s I
山 采集	s 蹦栋
山 出版社	s X┆
山 堤	s 出
山 顶风	s 郴
山 发大财	s oj]
山 发现	s o{
山 返家	s 甬a
山 共和国	s @M瓣
山 共同	s @P
山 国家	s 瓣a
山 开采	s }蹦
山 开发	s }o
山 苦斗	s W矮
山 树立	s 攫ミ
山 树木	s 攫れ
山 万	s U
山 意识	s N醚
山 造纸厂	s y燃t
山 植树	s 从攫
山 主席	s Du
山 装甲兵	s 杆ヒL
山 作出	s @X
山 兮	s ぜ
闪 出	{ X
闪 发光	{ o
善 坚持	到 绊
善 溪	到 匪
墒 秋	a 
商 并	坝 }
商 采取	坝 蹦
商 发动	坝 o笆
商 共同	坝 @P
商 开发	坝 }o
商 签	坝 帽
商 总公司	坝 `そq
商 足迹	坝 ì格
上 安全帽	W wU
上 百万	W κU
上 板	W O
上 背	W I
上 奔驰	W b梗
上 并	W }
上 播放	W 冀
上 采矿	W 蹦q
上 采取	W 蹦
上 采用	W 蹦ノ
上 采	W 蹦
上 查出	W dX
上 超额	W WB
上 撤出	W MX
上 澄清	W 坚M
上 出人意料	W XHN
上 出售	W X扳
上 出现	W X{
上 打柴	W ゴ
上 打出	W ゴX
上 大家	W ja
上 当家	W 讽a
上 登出	W nX
上 地质学家	W a借厩a
上 顶峰	W 郴p
上 敦促	W 窗P
上 发表声明	W o砹n
上 发表演说	W o砗t弧
上 发表	W o
上 发出	W oX
上 发动	W o笆
上 发挥	W o揣
上 发起	W o_
上 发生	W oネ
上 发现	W o{
上 发行	W o
上 发展	W oi
上 发	W o
上 丰	W 伦
上 扶持	W н
上 付出	W IX
上 公布	W そガ
上 公共厕所	W そ@Z┮
上 公家	W そa
上 共产	W @玻
上 共同	W @P
上 共有	W @Τ
上 共	W @
上 果树	W G攫
上 焊	W k
上 合格	W X
上 家	W a
上 坚持	W 绊
上 坚定	W 绊w
上 坚决	W 绊M
上 解释	W 秆睦
上 开发	W }o
上 看出	W 荪X
上 流露出	W ySX
上 露出	W SX
上 妈妈	W 洱洱
上 明显	W 陪
上 摩托车	W 集Λó
上 默默无闻	W qqLD
上 默默	W qq
上 拿出	W 偿X
上 能够	W 喟
上 鸟巢	W 尘_
上 拍照	W ╃酚
上 扑	W 汲
上 千万	W dU
上 签名	W 帽W
上 签署	W 帽p
上 签字	W 帽r
上 签	W 帽
上 趋向	W 镣V
上 扔下	W サU
上 瑞雪兆丰年	W 风撤伦~
上 散发	W 床o
上 舍	W 
上 摄影家	W 尼va
上 渗出	W 函X
上 手术台	W もNx
上 树立	W 攫ミ
上 树木	W 攫れ
上 树梢	W 攫遍
上 树	W 攫
上 苏	W 默
上 提出	W 矗X
上 突出	W 馥X
上 推陈出新	W 崩朝Xs
上 推出	W 崩X
上 脱颖而出	W 叉oτX
上 万家灯火	W UaO
上 万人	W UH
上 万	W U
上 为非作歹	W 矮D@わ
上 现出	W {X
上 星罗棋布	W P霉囱ガ
上 宣布	W 钮
上 血迹	W 甯
上 严格	W Y
上 一共	W @@
上 植树	W 从攫
上 指出	W X
上 治疗	W v励
上 种树	W 贺攫
上 主席台	W Dux
上 茁壮成长	W _ЁΘ
上 自家	W 郛a
上 总共	W `@
上 做文章	W 暗ゅ彻
上 作出	W @X
少 并	ぶ }
少 城市	ぶ 哎
少 出色	ぶ X
少 出现	ぶ X{
少 当年	ぶ 讽~
少 发文	ぶ oゅ
少 发	ぶ o
少 分析家	ぶ だRa
少 共同	ぶ @P
少 共	ぶ @
少 国家	ぶ 瓣a
少 回家	ぶ ^a
少 家长	ぶ a
少 家庭	ぶ ax
少 课堂	ぶ 揭绑
少 默默无闻	ぶ qqLD
少 批发	ぶ уo
少 启发	ぶ 币o
少 情况	ぶ 薄p
少 树	ぶ 攫
少 挑战	ぶ D驹
少 文章	ぶ ゅ彻
少 无家可归	ぶ Laik
少 溪	ぶ 匪
少 艺术	ぶ 美N
少 支出	ぶ やX
少 植树	ぶ 从攫
少 专家	ぶ Ma
邵 万	 U
绍 发	残 o
绍 家	残 a
舍 巴	 ぺ
舍 搬	 h
舍 保证	 O谍
舍 表示	 恁
舍 不得	 ぃo
舍 茶馆	 ]
舍 处处	 BB
舍 串	 
舍 此	 
舍 得	 o
舍 的	 
舍 地	 a
舍 递交	 患ユ
舍 都	 常
舍 对	 癸
舍 恩	 
舍 尔	 焊
舍 费	 O
舍 夫	 ひ
舍 宫	 c
舍 海	 
舍 和	 M
舍 还要	 临n
舍 及	 の
舍 己	 v
舍 建议	 啬
舍 结束	 挡
舍 今天	 さぱ
舍 近	 
舍 就	 N
舍 举行	 |
舍 克	 J
舍 勒	 扒
舍 雷	 p
舍 利	 Q
舍 强调	 j秸
舍 认为	 {
舍 瑞	 风
舍 身	 ō
舍 生	 ネ
舍 时	 
舍 是	 O
舍 说	 弧
舍 同	 P
舍 瓦	 ニ
舍 外长	 ~
舍 韦	 
舍 先生	 ネ
舍 耶	 C
舍 已	 w
舍 在	 b
舍 镇	 马
舍 争	 
舍 中	 い
舍 重申	 ビ
舍 主张	 Di
舍 最后	 程
舍 最近	 程
舍 作为	 @
摄 出	尼 X
摄 完毕	尼 Ч拨
涉 苏联	A 默p
涉 苏	A 默
涉 西藏	A 杪
社 驳斥	 婚ジ
社 出版	 X
社 发表声明	 o砹n
社 发表	 o
社 发放	 o
社 发挥	 o揣
社 发起	 o_
社 发现	 o{
社 扶持	 н
社 共同	 @P
社 共	 @
社 观察家	 [诡a
社 坚持	 绊
社 名誉主席	 WADu
社 拿出	 偿X
社 签	 帽
社 指出	 X
社 主席	 Du
设 技术	] мN
设 武术	] ZN
设 专家	] Ma
设 专门委员会	] Me|
设 专门	] M
申 尊敬	ビ Lq
身 板	ō O
身 背	ō I
身 斗	ō 矮
身 发财	ō o]
身 发达	ō oF
身 丰	ō 伦
身 技术	ō мN
身 居家	ō ~a
身 佩	ō ㄘ
身 扑向	ō 汲V
身 体验	ō 砰喷
身 植树	ō 从攫
深 发展	` oi
神 采	 蹦
沈 家	H a
沈 坚	H 绊
沈 佩	H ㄘ
沈 树	H 攫
审 并	f }
审 发	f o
甚 丰	 伦
声 出席	n Xu
声 发现	n o{
生 出席	ネ Xu
生 发表	ネ o
生 发现	ネ o{
生 发	ネ o
生 丰	ネ 伦
生 家属	ネ a妮
生 坚持	ネ 绊
生 明显	ネ 陪
生 签证	ネ 帽谍
生 杉树	ネ 攫
生 十万	ネ QU
生 树	ネ 攫
生 宿舍	ネ J
生 提出	ネ 矗X
生 学术	ネ 厩N
生 植树	ネ 从攫
生 指出	ネ X
生 走出	ネ ǐX
绳 指出	梅 X
省 百万	 κU
省 报名	 厨W
省 采取	 蹦
省 查出	 dX
省 城市	 哎
省 抽出	 ┾X
省 出版	 X
省 出口商	 Xf坝
省 出口	 Xf
省 出席	 Xu
省 出现	 X{
省 出	 X
省 发出	 oX
省 发电	 oq
省 发动	 o笆
省 发放	 o
省 发行	 o
省 发展	 oi
省 丰	 伦
省 格	 
省 公布	 そガ
省 共产党员	 @玻囊
省 共和	 @M
省 共青团	 @C刮
省 共生	 @ネ
省 共有	 @Τ
省 共	 @
省 果树	 G攫
省 技术监督	 мN菏服
省 技术	 мN
省 家喻户晓	 a畴め惧
省 坚持不懈	 绊ぃ居
省 坚持	 绊
省 进出口	 iXf
省 开发	 }o
省 批发	 уo
省 情况	 薄p
省 秋	 
省 肉类	 ψ摸
省 实行宵禁	 龟娈dT
省 苏州	 默{
省 特殊	 S
省 提出	 矗X
省 推出	 崩X
省 外出	 ~X
省 万	 U
省 宣布	 钮
省 严格	 Y
省 演出	 tX
省 艺术馆	 美N]
省 艺术	 美N
省 政府发言人	 F┎oēH
省 专门	 M
省 走出	 ǐX
省 作出	 @X
盛 昂	脖 
盛 发	脖 o
盛 况	脖 p
盛 树	脖 攫
盛 有限公司	脖 Τそq
胜 阿根廷	秤 讧
胜 杯	秤 M
胜 伦	秤 
胜 佩	秤 ㄘ
胜 苏联	秤 默p
胜 苏	秤 默
圣 发现	t o{
圣 伦	t 
师 出动	v X笆
师 情况	v 薄p
师 涂	v 额
失 情况	ア 薄p
施 出	I X
施 农家	I Aa
施 佩	I ㄘ
施 舍	I 
施 术	I N
施 托	I Λ
诗 家	钢 a
十 发	Q o
十 家	Q a
石 雕像	ホ J钩
石 雕	ホ J
石 发电	ホ oq
石 发动	ホ o笆
石 共	ホ @
石 家	ホ a
石 开发	ホ }o
石 瀑布	ホ rガ
石 塌方	ホ 厄よ
石 指出	ホ X
时 并	 }
时 播放	 冀
时 采取	 蹦
时 采用	 蹦ノ
时 城市	 哎
时 出版	 X
时 出示	 Xボ
时 出席	 Xu
时 出现	 X{
时 敦促	 窗P
时 发表声明	 o砹n
时 发表	 o
时 发布	 oガ
时 发出	 oX
时 发放	 o
时 发挥	 o揣
时 发起	 o_
时 发生	 oネ
时 发下	 oU
时 发现	 o{
时 发展	 oi
时 发	 o
时 付出	 IX
时 公布	 そガ
时 共	 @
时 国家	 瓣a
时 坚持	 绊
时 紧张	 候i
时 开发	 }o
时 能够	 喟
时 启发	 币o
时 签署	 帽p
时 签	 帽
时 实行宵禁	 龟娈dT
时 苏联	 默p
时 提出	 矗X
时 挺身而出	 绩τX
时 宣布	 钮
时 严格	 Y
时 预测	 w代
时 指出	 X
时 转发	 锣o
时 作出	 @X
什 布	ぐ ガ
什 出	ぐ X
什 发表	ぐ o
什 共	ぐ @
什 伦	ぐ 
什 签署	ぐ 帽p
什 提出	ぐ 矗X
什 托	ぐ Λ
什 宣布	ぐ 钮
什 指出	ぐ X
什 作出	ぐ @X
食 扶持	 н
实 敦厚	龟 窗p
实 丰	龟 伦
实 风格	龟 樊
实 情况	龟 薄p
实 秋	龟 
史 并	v }
史 出版社	v X┆
史 家	v a
史 专家	v Ma
使 不结盟国家	ㄏ ぃ挡幅瓣a
使 查出	ㄏ dX
使 城市	ㄏ 哎
使 出口	ㄏ Xf
使 大家	ㄏ ja
使 斗争	ㄏ 矮
使 发达	ㄏ oF
使 发动机	ㄏ o笆诀
使 发展	ㄏ oi
使 格	ㄏ 
使 共同	ㄏ @P
使 国家	ㄏ 瓣a
使 技术	ㄏ мN
使 家	ㄏ a
使 坚持	ㄏ 绊
使 开发	ㄏ }o
使 喇嘛	ㄏ 斥估
使 罗布	ㄏ 霉ガ
使 企业家	ㄏ ~a
使 前列腺	ㄏ eC涪
使 全家	ㄏ a
使 塞浦路斯	ㄏ 峨隔吹
使 手术	ㄏ もN
使 苏联	ㄏ 默p
使 苏州	ㄏ 默{
使 苏	ㄏ 默
使 提出	ㄏ 矗X
使 万	ㄏ U
使 武术	ㄏ ZN
使 西藏	ㄏ 杪
使 西欧国家	ㄏ 杓诎戤a
使 凶暴	ㄏ た忌
使 植树	ㄏ 从攫
使 治疗	ㄏ v励
使 自古以来	ㄏ 邾jHㄓ
驶 出	p X
始 采取	l 蹦
始 发	l o
式 并	Α }
式 城市	Α 哎
式 出	Α X
式 发酵法	Α o幻k
式 发酵	Α o幻
式 公共	Α そ@
式 共青团	Α @C刮
式 合格	Α X
式 家喻户晓	Α a畴め惧
式 战斗轰炸机	Α 驹矮F稻
式 战斗机	Α 驹矮诀
士 出口加工区	h Xf[u跋
士 共	h @
士 家庭	h ax
世 达赖喇嘛	@ F苦斥估
世 发	@ o
世 伦	@ 
世 乓	@ ャ
事 并	ㄆ }
事 出现	ㄆ X{
事 发表	ㄆ o
事 发愁	ㄆ oT
事 发生	ㄆ oネ
事 发	ㄆ o
事 迹	ㄆ 格
事 启发	ㄆ 币o
事 提出抗议	ㄆ 矗Xк某
事 提出	ㄆ 矗X
事 引出	ㄆ まX
事 作出	ㄆ @X
势 发表	墩 o
是 阿根廷	O 讧
是 昂贵	O Q
是 巴尔干国家	O ぺ焊F瓣a
是 板	O O
是 半路出家	O b隔Xa
是 暴发户	O 忌oめ
是 杯水车薪	O M舁~
是 背道而驰	O IDτ梗
是 背水一战	O I簸@驹
是 逼	O G
是 别具一格	O Oㄣ@
是 布	O ガ
是 采掘	O 蹦备
是 采取	O 蹦
是 采用	O 蹦ノ
是 采	O 蹦
是 城市	O 哎
是 初级产品价格	O 殳挪＋~基
是 出风头	O X防Y
是 出国	O X瓣
是 出口	O Xf
是 出名	O XW
是 出生	O Xネ
是 出席	O Xu
是 出现	O X{
是 出自	O X
是 出	O X
是 达赖喇嘛	O F苦斥估
是 大家	O ja
是 当年	O 讽~
是 吊板	O QO
是 斗争	O 矮
是 斗	O 矮
是 独树一帜	O W攫@m
是 发出	O oX
是 发达	O oF
是 发放	O o
是 发给	O o倒
是 发挥	O o揣
是 发生	O oネ
是 发现	O o{
是 发展	O oi
是 发	O o
是 非战斗人员	O D驹矮H
是 丰	O 伦
是 扶	O н
是 附属国	O 妮瓣
是 哥伦比亚	O 舡郅瘿
是 格	O 
是 共产党员	O @玻囊
是 共产党	O @玻囊
是 共产主义	O @玻Dq
是 共和国	O @M瓣
是 共青团	O @C刮
是 共同	O @P
是 国家	O 瓣a
是 海伦	O 
是 合格	O X
是 画家	O ea
是 化妆箱	O てЗc
是 化妆	O てЗ
是 火力发电厂	O 酩Ooqt
是 火山爆发	O 酩szo
是 极为	O 伐
是 技术人员	O мNH
是 技术	O мN
是 家常便饭	O a`K逗
是 家家户户	O aaめめ
是 家庭教育	O ax毙|
是 家庭	O ax
是 家乡	O am
是 家用	O aノ
是 家喻户晓	O a畴め惧
是 家	O a
是 坚持不懈	O 绊ぃ居
是 坚持	O 绊
是 坚定不移	O 绊wぃ簿
是 坚定	O 绊w
是 坚决	O 绊M
是 坚	O 绊
是 江苏	O 磕
是 解释	O 秆睦
是 金融界	O 骺默
是 精雕细琢	O 弘J灿Z
是 经济学家	O g蕾厩a
是 开发	O }o
是 老糊涂	O ρk额
是 领头	O 烩Y
是 楼房	O 加┬
是 伦敦	O 鄞
是 妈妈	O 洱洱
是 漫不经心	O 憨ぃgみ
是 漫	O 憨
是 每况愈下	O CpUU
是 明显	O 陪
是 摩托车	O 集Λó
是 能够	O 喟
是 女作家	O k@a
是 佩服	O ㄘA
是 佩	O ㄘ
是 企业家	O ~a
是 千千万万	O ddUU
是 秋	O 
是 全家	O a
是 塞浦路斯	O 峨隔吹
是 石油输出国组织	O ホo块X瓣舱麓
是 树根	O 攫
是 树立	O 攫ミ
是 水土流失	O 簸gyア
是 四个坚持	O |影慝
是 苏联	O 默p
是 苏州	O 默{
是 苏	O 默
是 踏步	O 今B
是 特殊	O S
是 提出	O 矗X
是 挑战	O D驹
是 托	O Λ
是 万	O U
是 威逼	O 鹿G
是 违背	O HI
是 违法	O Hk
是 违反	O Hは
是 文章	O ゅ彻
是 无坚不摧	O L绊ぃR
是 西藏	O 杪
是 西欧国家	O 杓诎戤a
是 现阶段	O {顶q
是 相思树	O 郢渚
是 邢	O ǚ
是 亚洲开发银行	O ㄈw}o蝗
是 严格	O Y
是 野心家	O 偿みa
是 一家人	O @aH
是 一片凄凉	O @YD
是 医疗	O 洛励
是 依托	O ㄌΛ
是 艺术	O 美N
是 意识	O N醚
是 英格兰	O ^婺
是 有目共睹	O Τヘ@@
是 有希望	O Τ票
是 有限	O Τ
是 冤家	O 蕻a
是 战斗	O 驹矮
是 政治体制	O Fv砰
是 治疗	O v励
是 中华人民共和国	O い地Hチ@M瓣
是 专家	O Ma
是 专门	O M
是 自发	O 鄣o
是 作家	O @a
适 树	A 攫
氏 杯	ん M
氏 疗法	ん 励k
氏 熏	ん 饫
市 昂昂	カ 
市 百万	カ κU
市 颁发	カ {o
市 采访	カ 蹦X
市 采	カ 蹦
市 查出	カ dX
市 城市	カ 哎
市 出差	カ Xt
市 出口商	カ Xf坝
市 出席	カ Xu
市 出现	カ X{
市 出租汽车	カ X波Tó
市 出租	カ X
市 发表演说	カ o砗t弧
市 发电厂	カ oqt
市 发动机	カ o笆诀
市 发动	カ o笆
市 发挥	カ o揣
市 发起	カ o_
市 发行	カ o
市 发展	カ oi
市 发	カ o
市 丰	カ 伦
市 公布	カ そガ
市 公共汽车	カ そ@Tó
市 公共	カ そ@
市 共有	カ @Τ
市 共	カ @
市 技术监督	カ мN菏服
市 技术	カ мN
市 价格	カ 基
市 坚持	カ 绊
市 开发	カ }o
市 客家	カ 犬a
市 漫步	カ 憨B
市 漫	カ 憨
市 美术家	カ Na
市 排出	カ 逼X
市 舍	カ 
市 摄影家	カ 尼va
市 书法家	カ 血ka
市 树	カ 攫
市 苏维埃	カ 默蝴J
市 苏	カ 默
市 塌陷	カ 厄炒
市 特殊	カ S
市 提出	カ 矗X
市 推出	カ 崩X
市 万花	カ U
市 万	カ U
市 西藏	カ 杪
市 溪	カ 匪
市 演出	カ tX
市 艺术	カ 美N
市 专门	カ M
市 走出	カ ǐX
室 发现	 o{
室 拿出	 偿X
视 国家	跌 瓣a
视 皮层	跌 ブh
视 情况	跌 薄p
视 有限公司	跌 Τそq
试 采	刚 蹦
试 出	刚 X
试 阶段	刚 顶q
试 情况	刚 薄p
收 杯	Μ M
收 额外费用	Μ B~Oノ
收 额	Μ B
收 极为	Μ 伐
收 金额	Μ 髅B
收 托	Μ Λ
收 外来	Μ ~ㄓ
收 作出	Μ @X
手 报名	も 厨W
手 并	も }
手 布	も ガ
手 铲	も 藐
手 出	も X
手 发颤	も o鸥
手 发起	も o_
手 扶	も н
手 共	も @
手 能够	も 喟
手 情况	も 薄p
手 苏	も 默
手 挑战	も D驹
首 发	 o
首 家	 a
守 发笑	u o
守 发	u o
寿 杯	关 M
售 出	扳 X
售 国家	扳 瓣a
受 不法之徒	 ぃkぇ{
受 布	 ガ
受 共青团	 @C刮
受 国家	 瓣a
受 技术	 мN
受 配额	 tB
受 启发	 币o
受 亲戚	 克杯
受 石油输出国组织	 ホo块X瓣舱麓
兽 出没	~ XS
梳 出	 X
殊 死拼	 韩
殊 死	 
殊 先生	 ネ
抒 发	х o
书 并	 }
书 出版	 X
书 出	 X
书 额	 B
书 共	 @
书 签字	 帽r
书 突出	 馥X
书 推出	 崩X
书 指出	 X
书 专门	 M
熟 采	剪 蹦
熟 丰	剪 伦
熟 技术	剪 мN
熟 阶段	剪 顶q
熟 开发	剪 }o
署 发布	p oガ
署 提出	p 矗X
署 预测	p w代
署 指出	p X
属 国家	妮 瓣a
属 家	妮 a
属 苏联	妮 默p
属 苏	妮 默
属 违反	妮 Hは
术 成功	N Θ\
术 分	N だ
术 更	N 
术 和	N M
术 后患	N 岜w
术 后	N 
术 会议	N |某
术 前	N e
术 时	N 
术 式	N Α
术 是	N O
术 脱	N 叉
术 训练	N Vm
术 展	N i
术 治疗	N v励
术 中	N い
述 苏联	z 默p
树 保	攫 O
树 备	攫 称
树 被	攫 Q
树 标	攫 夹
树 滨	攫 镭
树 不见	攫 ぃǎ
树 才能	攫 ~
树 采取	攫 蹦
树 参天	攫 把ぱ
树 藏	攫 旅
树 草原	攫 蟓
树 叉	攫 e
树 长	攫 
树 成材	攫 Θ
树 成行	攫 Θ
树 成	攫 Θ
树 出现	攫 X{
树 村	攫 
树 代	攫 N
树 当做	攫 讽暗
树 的	攫 
树 等	攫 单
树 低	攫 C
树 动用	攫 笆ノ
树 洞	攫 }
树 都	攫 常
树 对	攫 癸
树 多	攫 h
树 芳	攫 
树 方案	攫 よ
树 房	攫 ┬
树 访问	攫 X拜
树 夫妇	攫 ひ包
树 副	攫 捌
树 覆盖	攫 滦\
树 高	攫 蔼
树 工作	攫 u@
树 挂	攫 本
树 冠	攫 a
树 广	攫 s
树 过程	攫 L{
树 海	攫 
树 航	攫 
树 和	攫 M
树 红	攫 
树 护	攫 @
树 花	攫 
树 还	攫 临
树 黄花	攫 独
树 黄	攫 独
树 获得	攫 莉o
树 及	攫 の
树 家族	攫 a壁
树 见	攫 ǎ
树 将	攫 N
树 街道	攫 刁D
树 街	攫 刁
树 结束	攫 挡
树 今天	攫 さぱ
树 进行	攫 i
树 径	攫 |
树 就	攫 N
树 举行	攫 |
树 开花	攫 }
树 开往	攫 }┕
树 砍	攫 
树 坑	攫 |
树 腊	攫 镁
树 啦	攫 罢
树 来	攫 ㄓ
树 兰	攫 孽
树 老	攫 ρ
树 累计	攫 仓p
树 梨	攫 冰
树 良	攫 }
树 了	攫 F
树 龄	攫 闹
树 岭	攫 拉
树 满	攫 骸
树 每年	攫 C~
树 门	攫 
树 迷	攫 g
树 名	攫 W
树 难	攫 螟
树 培	攫 蚌
树 品	攫 ~
树 平	攫 キ
树 七	攫 C
树 起来	攫 _ㄓ
树 起	攫 _
树 强	攫 j
树 青	攫 C
树 琼	攫 茫
树 权	攫 v
树 群	攫 s
树 仁	攫 く
树 如	攫 p
树 森	攫 此
树 上山	攫 Ws
树 上	攫 W
树 少	攫 ぶ
树 使	攫 ㄏ
树 是	攫 O
树 手	攫 も
树 首相	攫 含
树 说	攫 弧
树 死亡	攫 氦`
树 随	攫 H
树 他们	攫 L
树 庭	攫 x
树 桐	攫 
树 同	攫 P
树 捅	攫 讯
树 挽	攫 
树 万	攫 U
树 威	攫 
树 为学	攫 熬
树 为	攫 
树 未	攫 ゼ
树 稀	攫 }
树 下面	攫 U
树 下	攫 U
树 现在	攫 {b
树 县	攫 郡
树 新	攫 s
树 信	攫 H
树 兴	攫 砍
树 行业	攫 娣~
树 雄心	攫 动み
树 学	攫 厩
树 勋	攫 吃
树 压住	攫 溃
树 研究	攫 悒s
树 言	攫 ē
树 耀	攫 模
树 也	攫 ]
树 业	攫 ~
树 一再	攫 @A
树 一直	攫 @
树 一	攫 @
树 已经	攫 wg
树 已	攫 w
树 应	攫 莱
树 用	攫 ノ
树 有	攫 Τ
树 幼苗	攫 ギ]
树 于	攫 _
树 远	攫 环
树 栽培	攫 獍
树 栽	攫 
树 再次	攫 AΩ
树 在	攫 b
树 早期	攫 Ν戳
树 整流器	攫 俱y竟
树 正气	攫 タ
树 只	攫 u
树 种	攫 贺
树 重点	攫 I
树 逐一	攫 v@
树 转	攫 锣
树 籽	攫 
树 组阁	攫 舱徽
树 蓊	攫 c
树 楠	攫 罚
树 铎	攫 M
竖 板	捷 O
数 百万吨	计 κU痉
数 百万	计 κU
数 共产党	计 @玻囊
数 共计	计 @p
数 共有	计 @Τ
数 家	计 a
数 明显	计 陪
数 千万	计 dU
数 十万	计 QU
数 万人	计 UH
数 万	计 U
数 限额	计 B
甩 出	ハ X
帅 家	 a
霜 斗	流 矮
双 杯	蛮 M
双 布鞋	蛮 ガc
双 雕	蛮 J
双 发	蛮 o
双 丰	蛮 伦
双 万	蛮 U
谁 出钱	街 X窥
谁 家	街 a
谁 开发	街 }o
谁 能够	街 喟
谁 违反	街 Hは
谁 宣布	街 钮
水 发电	 oq
水 发	 o
水 丰	 伦
水 共	 @
水 葫芦	 脯莫
水 技术	 мN
水 家	 a
水 开采	 }蹦
水 漫	 憨
水 散发	 床o
水 意识	 N醚
水 蒸发	 ]o
水 作出	 @X
睡 地板	何 aO
税 共	| @
税 金额	| 髅B
税 明显	| 陪
瞬 发	俐 o
顺 出口	抖 Xf
顺 扶	抖 н
顺 价格	抖 基
说 出口	弧 Xf
说 出来	弧 Xㄓ
说 共同	弧 @P
说 坚持	弧 绊
说 聊斋	弧 册N
说 情况	弧 薄p
说 苏联	弧 默p
斯 颁发	吹 {o
斯 杯	吹 M
斯 并	吹 }
斯 布	吹 ガ
斯 撤出	吹 MX
斯 出席	吹 Xu
斯 出	吹 X
斯 发表声明	吹 o砹n
斯 发挥	吹 o揣
斯 共和国	吹 @M瓣
斯 国家	吹 瓣a
斯 摩托车	吹 集Λó
斯 佩	吹 ㄘ
斯 签	吹 帽
斯 秋	吹 
斯 提出	吹 矗X
斯 托	吹 Λ
斯 宣布	吹 钮
斯 指出	吹 X
斯 作出	吹 @X
斯 作家	吹 @a
斯 珀	吹 
思 违反	 Hは
私 斗争	p 矮
死 搏斗	 i矮
四 杯	| M
四 城市	| 哎
四 出	| X
四 家	| a
四 阶段	| 顶q
似 发	 o
松 柏树	P f攫
松 发表声明	P o砹n
松 发	P o
松 默默	P qq
松 树	P 攫
松 苏	P 默
松 提出	P 矗X
松 走出	P ǐX
送 出去	e Xh
送 发	e o
送 饭菜	e 逗垫
送 国家	e 瓣a
送 秋	e 
宋 丰	Ш 伦
宋 家	Ш a
宋 树	Ш 攫
宋 文章	Ш ゅ彻
搜 出	j X
艘 苏联	看 默p
苏 阿	默 
苏 艾	默 
苏 奥	默 而
苏 巴	默 ぺ
苏 把	默 р
苏 罢工	默 }u
苏 百	默 κ
苏 保	默 O
苏 北	默 _
苏 贝	默 ī
苏 比	默 ゑ
苏 边界	默 娩
苏 边境	默 娩挂
苏 边	默 娩
苏 不仅	默 ぃ度
苏 布	默 ガ
苏 步	默 B
苏 部队	默 场钉
苏 裁军	默 掉x
苏 采取	默 蹦
苏 参加	默 把[
苏 草	默 
苏 长期	默 戳
苏 撤军	默 Mx
苏 成功	默 Θ\
苏 成立	默 Θミ
苏 出口	默 Xf
苏 传授	默 肚甭
苏 传	默 肚
苏 从	默 q
苏 磋商	默 R坝
苏 达成	默 FΘ
苏 大使	默 jㄏ
苏 大	默 j
苏 当局	默 讽Ы
苏 德	默 w
苏 的	默 
苏 等	默 单
苏 地方	默 aよ
苏 地区	默 a跋
苏 地图	默 a瓜
苏 蒂	默 甫
苏 第一	默 材@
苏 第	默 材
苏 都	默 常
苏 队员	默 钉
苏 对	默 癸
苏 尔	默 焊
苏 发表	默 o
苏 发明	默 o
苏 发射	默 og
苏 发展	默 oi
苏 发	默 o
苏 法	默 k
苏 方	默 よ
苏 访问	默 X拜
苏 菲	默 滇
苏 副总统	默 捌`参
苏 副	默 捌
苏 高级	默 蔼
苏 隔阂	默 j灰
苏 各自	默 U
苏 各	默 U
苏 公布	默 そガ
苏 共和	默 @M
苏 共	默 @
苏 古	默 j
苏 关	默 闽
苏 官方	默 xよ
苏 官员	默 x
苏 冠军	默 ax
苏 光	默 
苏 归	默 k
苏 国防部	默 瓣境
苏 国际	默 瓣悔
苏 国	默 瓣
苏 哈	默 
苏 海图	默 瓜
苏 海运	默 B
苏 韩	默 龙
苏 航	默 
苏 核武器	默 知Z竟
苏 和平	默 Mキ
苏 和	默 M
苏 合作	默 X@
苏 赫	默 划
苏 红	默 
苏 厚	默 p
苏 后	默 
苏 华盛顿	默 地脖y
苏 惠	默 f
苏 获	默 莉
苏 货运	默 fB
苏 吉	默 N
苏 及	默 の
苏 即将	默 YN
苏 计划	默 p购
苏 纪	默 
苏 家	默 a
苏 加紧	默 [候
苏 加强	默 [j
苏 贾	默 鸽
苏 检查	默 浪d
苏 健	默 胺
苏 建立	默 廿
苏 建议	默 啬
苏 将	默 N
苏 教练	默 毙m
苏 接近	默 钡
苏 杰	默 城
苏 捷	默 倍
苏 结果	默 挡G
苏 今后	默 さ
苏 进行	默 i
苏 进一步	默 i@B
苏 经济	默 g蕾
苏 经	默 g
苏 静	默 R
苏 境	默 挂
苏 就	默 N
苏 局	默 Ы
苏 举行	默 |
苏 决定	默 Mw
苏 军备竞赛	默 x称v辽
苏 军备	默 x称
苏 军队	默 x钉
苏 军事	默 xㄆ
苏 军	默 x
苏 开创	默 }承
苏 开始	默 }l
苏 开	默 }
苏 科技	默 歆
苏 科学家	默 炀钱a
苏 克	默 J
苏 拉	默 ┰
苏 莱	默 弟
苏 来	默 ㄓ
苏 老	默 ρ
苏 里	默 
苏 立	默 ミ
苏 联合公报	默 pXそ厨
苏 联合委员会	默 pXe|
苏 联合	默 pX
苏 两	默 ㄢ
苏 林场	默 L初
苏 凌云	默 舛
苏 领导人	默 烩旧H
苏 鲁	默 |
苏 伦	默 
苏 罗	默 霉
苏 落幕	默 辅辊
苏 洛	默 
苏 麦	默 沉
苏 貌	默 华
苏 贸易额	默 T雒B
苏 贸易谈判	默 T鼋艇P
苏 贸易	默 T
苏 美德	默 w
苏 美	默 
苏 蒙	默 X
苏 明	默 
苏 摩尔	默 集焊
苏 莫斯科	默 馋吹
苏 睦	默 伏
苏 纳	默 
苏 南	默 n
苏 内阁	默 ず徽
苏 内务	默 ず叭
苏 内政	默 ずF
苏 能	默 
苏 农科	默 A
苏 女子	默 kl
苏 女	默 k
苏 欧	默 稼
苏 培	默 蚌
苏 平	默 キ
苏 普	默 炊
苏 期间	默 戳丁
苏 期望	默 戳辨
苏 签署	默 帽p
苏 谴责	默 宁d
苏 强调	默 j秸
苏 区	默 跋
苏 取得	默 o
苏 去年	默 h~
苏 权	默 v
苏 全民	默 チ
苏 拳击	默 崩
苏 热线电话	默 荐uq杠
苏 人民	默 Hチ
苏 认为	默 {
苏 日	默 ら
苏 萨	默 履
苏 三国	默 T瓣
苏 三	默 T
苏 珊	默 
苏 陕	默 阿
苏 尚	默 |
苏 少年犯罪	默 ぶ~デo
苏 社会	默 婪|
苏 时	默 
苏 实施	默 龟I
苏 实现	默 龟{
苏 使馆	默 ㄏ]
苏 首脑	默 焊
苏 授予	默 甭ぉ
苏 叔	默 
苏 双方	默 蛮よ
苏 双	默 蛮
苏 顺	默 抖
苏 斯	默 吹
苏 四	默 |
苏 特	默 S
苏 廷	默 
苏 通过	默 qL
苏 土	默 g
苏 瓦	默 ニ
苏 外长	默 ~
苏 外交部	默 ~ユ场
苏 外交	默 ~ユ
苏 威	默 
苏 为了	默 挨F
苏 维	默 蝴
苏 武	默 Z
苏 五	默 き
苏 锡	默 奎
苏 希望	默 票
苏 县	默 郡
苏 享有	默 ㄉΤ
苏 向	默 V
苏 削减	默 d搭
苏 销毁	默 P反
苏 新型	默 s
苏 匈	默 I
苏 选民	默 匡チ
苏 选手	默 匡も
苏 学习	默 厩策
苏 亚	默 ㄈ
苏 研究出	默 悒sX
苏 研	默 
苏 邀请	默 淋叫
苏 要求	默 nD
苏 一	默 @
苏 移	默 簿
苏 已	默 w
苏 以及	默 Hの
苏 以	默 H
苏 意	默 N
苏 议会	默 某|
苏 英	默 ^
苏 应用	默 莱ノ
苏 应	默 莱
苏 犹太人	默 SびH
苏 犹太	默 Sび
苏 有关	默 Τ闽
苏 有	默 Τ
苏 友好	默 ねn
苏 友谊	默 ね剿
苏 于	默 _
苏 与	默 P
苏 宇	默 t
苏 预算	默 w衡
苏 原	默 
苏 在	默 b
苏 则	默 h
苏 扎	默 蚕
苏 战略	默 驹菠
苏 正式	默 タΑ
苏 政府	默 F┎
苏 支持	默 や
苏 之间	默 ぇ丁
苏 之前	默 ぇe
苏 指责	默 d
苏 制	默 
苏 治安	默 vw
苏 治病	默 vf
苏 治疗	默 v励
苏 中	默 い
苏 仲	默 ヲ
苏 主张	默 Di
苏 驻扎	默 n蚕
苏 驻	默 n
苏 专家	默 Ma
苏 子	默 l
苏 总统顾问	默 `参U拜
苏 总统	默 `参
苏 最	默 程
苏 桦	默 眷
素 作出反应	 @Xは莱
速 发展	t oi
酸 能够	荒 喟
算 出	衡 X
算 合格	衡 X
算 家	衡 a
虽 出现	瘤 X{
随 发	H o
岁 杯	烦 M
岁 出头	烦 XY
岁 发	烦 o
遂 宣布	E 钮
孙 家	] a
孙 敬	] q
孙 树	] 攫
损 共	l @
索 布	 ガ
索 出	 X
索 格	 
索 托	 Λ
索 溪	 匪
所 采取	┮ 蹦
所 采用	┮ 蹦ノ
所 出示	┮ Xボ
所 出现	┮ X{
所 发表	┮ o
所 发出	┮ oX
所 发动	┮ o笆
所 发挥	┮ o揣
所 发明	┮ o
所 发生	┮ oネ
所 发行	┮ o
所 发展	┮ oi
所 发	┮ o
所 扶植	┮ н从
所 付出	┮ IX
所 共青团	┮ @C刮
所 共同研究	┮ @P悒s
所 共	┮ @
所 坚持	┮ 绊
所 坚决	┮ 绊M
所 能够	┮ 喟
所 排出	┮ 逼X
所 签署	┮ 帽p
所 签	┮ 帽
所 散发	┮ 床o
所 宿舍	┮ J
所 特殊	┮ S
所 提出	┮ 矗X
所 推出	┮ 崩X
所 托	┮ Λ
所 校舍	┮ 摘
所 宣布	┮ 钮
所 预测	┮ w代
所 遭受	┮ D
所 指出	┮ X
所 专家	┮ Ma
所 专门	┮ M
所 作出	┮ @X
塌 的	厄 
塌 顶	厄 郴
塌 了	厄 F
塌 落	厄 辅
塌 上	厄 W
塌 下来	厄 Uㄓ
他 白手起家	L フも_a
他 报名	L 厨W
他 背水一战	L I簸@驹
他 背	L I
他 并	L }
他 采访	L 蹦X
他 采取	L 蹦
他 采用	L 蹦ノ
他 搀扶	L eн
他 出版	L X
他 出发	L Xo
他 出门	L X
他 出去	L Xh
他 出生后	L Xネ
他 出现	L X{
他 出	L X
他 当年	L 讽~
他 敦促	L 窗P
他 发表	L o
他 发出	L oX
他 发烧	L oN
他 发誓	L o}
他 发现	L o{
他 发	L o
他 风尘仆仆	L 饭泄补
他 扶	L н
他 付出	L IX
他 格外	L 妤~
他 共	L @
他 鼓掌	L 躬x
他 回家	L ^a
他 技术	L мN
他 家境	L a挂
他 家门	L a
他 家庭生活	L axネ
他 家	L a
他 坚持	L 绊
他 坚定不移	L 绊wぃ簿
他 坚定	L 绊w
他 坚决	L 绊M
他 坚信	L 绊H
他 坚贞不屈	L 绊sぃ}
他 结婚	L 挡B
他 解释	L 秆睦
他 敬	L q
他 举出	L |X
他 苦恼	L Wo
他 默默	L qq
他 拿出	L 偿X
他 排出	L 逼X
他 签名	L 帽W
他 钦佩	L 窜ㄘ
他 全家	L a
他 伸出	L X
他 书法家	L 血ka
他 苏丹	L 默う
他 苏醒	L 默眶
他 掏出	L 鼻X
他 提出	L 矗X
他 外出	L ~X
他 婉	L 胞
他 宣布	L 钮
他 研究出	L 悒sX
他 演出	L tX
他 一下子	L @Ul
他 意识到	L N醚
他 预测	L w代
他 珍惜	L 帽
他 指出	L X
他 治疗	L v励
他 专门	L M
他 仔细	L J灿
他 走下	L ǐU
他 足迹	L ì格
他 作出	L @X
它 并	ウ }
它 采取	ウ 蹦
它 采用	ウ 蹦ノ
它 出现	ウ X{
它 出资购买	ウ X戈潦R
它 发电	ウ oq
它 发挥	ウ o揣
它 发生	ウ oネ
它 发展	ウ oi
它 反驳	ウ は婚
它 公布	ウ そガ
它 共和国	ウ @M瓣
它 共同	ウ @P
它 共	ウ @
它 国家	ウ 瓣a
它 果树	ウ G攫
它 激发	ウ Eo
它 坚持	ウ 绊
它 坚决	ウ 绊M
它 看做	ウ 莅
它 乒乓球	ウ モャy
它 签署	ウ 帽p
它 提出	ウ 矗X
它 宣布	ウ 钮
它 医疗	ウ 洛励
它 艺术	ウ 美N
它 预测	ウ w代
它 战斗	ウ 驹矮
它 指出	ウ X
她 颁发	o {o
她 背	o I
她 并	o }
她 驳斥	o 婚ジ
她 采访	o 蹦X
她 出差	o Xt
她 出生	o Xネ
她 出	o X
她 当年	o 讽~
她 发表	o o
她 发出	o oX
她 发誓	o o}
她 发现	o o{
她 发	o o
她 扶起	o н_
她 共有	o @Τ
她 回家	o ^a
她 婚	o B
她 家	o a
她 坚持	o 绊
她 揭发	o 处o
她 敬	o q
她 救出	o 毕X
她 老家	o ρa
她 默默	o qq
她 拿出	o 偿X
她 能够	o 喟
她 扑	o 汲
她 全家	o a
她 舍	o 
她 伸出	o X
她 手术	o もN
她 树立	o 攫ミ
她 提出	o 矗X
她 一家人	o @aH
她 指出	o X
她 治疗	o v励
她 资格	o 戈
塔 出席	娥 Xu
塔 发表	娥 o
塔 格局	娥 妲
塔 格	娥 
塔 默	娥 q
胎 打气	L ゴ
抬 出场	╋ X初
抬 出	╋ X
台 播放	x 冀
台 驳斥	x 婚ジ
台 布	x ガ
台 采访	x 蹦X
台 采用	x 蹦ノ
台 测试	x 代刚
台 柴油发电	x 悛ooq
台 出版	x X
台 出口	x Xf
台 发表声明	x o砹n
台 发表	x o
台 发布	x oガ
台 发出	x oX
台 发射机	x og诀
台 发射塔	x og娥
台 发生	x oネ
台 发现	x o{
台 发	x o
台 反共	x は@
台 共	x @
台 焊接	x k钡
台 家用	x aノ
台 坚持	x 绊
台 水轮发电机	x 艚oq诀
台 宣布	x 钮
台 演出	x tX
台 艺术	x 美N
台 植树	x 从攫
台 作出	x @X
泰 斗	 矮
泰 跑出	 ]X
泰 签署	 帽p
泰 苏	 默
太 国家	び 瓣a
太 有希望	び Τ票
态 万	A U
坍 塌	~ 厄
摊 出	u X
贪 斗争	g 矮
滩 背	y I
滩 涂	y 额
滩 植树	y 从攫
坛 顶峰	韭 郴p
坛 发展	韭 oi
痰 迹	佛 格
潭 杯	兼 M
潭 国家	兼 瓣a
谭 家	糜 a
谈 出	酵 X
谈 发展	酵 oi
谈 国家	酵 瓣a
谈 技术	酵 мN
谈 家事	酵 aㄆ
谈 家乡	酵 am
谈 家	酵 a
谈 情况	酵 薄p
谈 苏联	酵 默p
谈 苏	酵 默
谈 西藏	酵 杪
坦 并	Z }
坦 布	Z ガ
坦 医疗	Z 洛励
坦 专家	Z Ma
探 出头	贝 XY
探 技术	贝 мN
探 家	贝 a
探 开采	贝 }蹦
探 开发	贝 }o
汤 发出	傣 oX
塘 背	俄 I
塘 春秋	俄 K
塘 格	俄 
堂 露出	绑 SX
堂 预测	绑 w代
棠 颁发	磁 {o
棠 出席	磁 Xu
棠 之外	磁 ぇ~
唐 布	 ガ
唐 家	 a
唐 树	 攫
糖 开发	} }o
趟 出路	诫 X隔
趟 家	诫 a
烫 发	S o
滔 发明	肥 o
桃 家	 a
逃 出	k X
逃 状况	k p
讨 并	Q }
套 把戏	M р栏
套 并	M }
套 出	M X
套 发展	M oi
套 丰	M 伦
套 共	M @
套 技术	M мN
套 价格	M 基
套 开发	M }o
套 启发	M 币o
套 宿舍	M J
套 严格	M Y
套 医疗	M 洛励
套 治疗	M v励
套 专门	M M
特 杯	S M
特 出席	S Xu
特 大丰收	S j伦Μ
特 敦促	S 窗P
特 发出	S oX
特 发展	S oi
特 格	S 
特 坚持	S 绊
特 伦	S 
特 亲笔	S 克掸
特 苏维埃	S 默蝴J
特 提出	S 矗X
特 万	S U
特 宣布	S 钮
特 有限公司	S Τそq
特 指出	S X
特 主席	S Du
腾 格	乃 
梯 楼房	辫 加┬
提 格	矗 
提 共和国	矗 @M瓣
提 指出	矗 X
题 提出	D 矗X
题 文章	D ゅ彻
题 作出	D @X
体 并	砰 }
体 采	砰 蹦
体 城市	砰 哎
体 出口	砰 Xf
体 发起	砰 o_
体 发生	砰 oネ
体 共同安全	砰 @Pw
体 共同市场	砰 @Pカ初
体 国家	砰 瓣a
体 合格	砰 X
体 坚持	砰 绊
体 开发	砰 }o
体 理事会主席	砰 zㄆ|Du
体 摩托车	砰 集Λó
体 能够	砰 喟
体 情况	砰 薄p
体 现出来	砰 {Xㄓ
体 现出	砰 {X
体 移植	砰 簿从
体 主席	砰 Du
体 专家	砰 Ma
体 作出	砰 @X
替 价格	蠢 基
替 配额	蠢 tB
替 手术	蠢 もN
剃 得	c o
剃 光	c 
天 采访	ぱ 蹦X
天 出版社	ぱ X┆
天 出生	ぱ Xネ
天 出现	ぱ X{
天 出	ぱ X
天 斗	ぱ 矮
天 发表	ぱ o
天 发电	ぱ oq
天 发射	ぱ og
天 发展	ぱ oi
天 丰	ぱ 伦
天 公布	ぱ そガ
天 回家	ぱ ^a
天 技术	ぱ мN
天 签	ぱ 帽
天 提出	ぱ 矗X
天 销售总额	ぱ P扳`B
天 宣布	ぱ 钮
天 演出	ぱ tX
天 植树	ぱ 从攫
天 治疗	ぱ v励
添 树木	K 攫れ
填 发	恶 o
田 采访	バ 蹦X
田 插秧	バ 础
田 共计	バ @p
田 技术	バ мN
田 敬	バ q
田 开发	バ }o
田 万	バ U
挑 出来	D Xㄓ
挑 出毛病	D Xをf
挑 出	D X
条 薄板	兵 痢O
条 薄布	兵 痢ガ
条 布	兵 ガ
条 采用	兵 蹦ノ
条 发生	兵 oネ
条 发展	兵 oi
条 扶	兵 н
条 格	兵 
条 公共汽车	兵 そ@Tó
条 共	兵 @
条 国家	兵 瓣a
条 焊缝	兵 k_
条 黑板	兵 堵O
条 开发	兵 }o
条 能够	兵 喟
条 平常	兵 キ`
条 签名	兵 帽W
条 水土	兵 簸g
条 特殊	兵 S
条 违反	兵 Hは
条 溪	兵 匪
条 治疗	兵 v励
条 中华人民共和国	兵 い地Hチ@M瓣
跳 背	铬 I
贴 出	K X
贴 家用	K aノ
贴 价格	K 基
铁 布	K ガ
铁 家	K a
铁 脚板	K }O
厅 总工程师	U `u{v
听 出	钮 X
听 大家	钮 ja
听 技术	钮 мN
廷 比	 ゑ
廷 等	 单
廷 队长	 钉
廷 古典	 jㄥ
廷 光	 
廷 贵	 Q
廷 海	 
廷 和	 M
廷 金鱼	 鞒
廷 今年	 さ~
廷 今天	 さぱ
廷 克	 J
廷 率领	 v烩
廷 茂	 Z
廷 模	 家
廷 奶	 イ
廷 说	 弧
廷 斯	 吹
廷 松	 P
廷 祥	 不
廷 享年	 ㄉ~
廷 孝	 У
廷 雅	 懂
廷 元	 じ
廷 远	 环
廷 在	 b
廷 昨晚	 Q边
廷 楣	 钒
停 并	氨 }
停 发	氨 o
亭 发电厂	F oqt
亭 家	F a
庭 采取	x 蹦
庭 宣布	x 钮
挺 丰	 伦
艇 出海	弗 X
通 杯	q M
通 并	q }
通 出席	q Xu
通 情况	q 薄p
通 万	q U
通 作出	q @X
同 阿根廷	P 讧
同 布置	P ガm
同 布	P ガ
同 出席	P Xu
同 出	P X
同 大家	P ja
同 当年	P 讽~
同 发达	P oF
同 发生	P oネ
同 发展	P oi
同 发	P o
同 哥伦比亚	P 舡郅瘿
同 共产党	P @玻囊
同 共和国	P @M瓣
同 国家主义	P 瓣aDq
同 国家	P 瓣a
同 皇家	P 赢a
同 家人	P aH
同 家	P a
同 坚持	P 绊
同 坚硬	P 绊w
同 金婚	P 鞅B
同 佩	P ㄘ
同 企业家	P ~a
同 签署	P 帽p
同 签	P 帽
同 树	P 攫
同 苏联	P 默p
同 苏	P 默
同 违背	P HI
同 违法	P Hk
同 西藏	P 杪
同 已出版	P wX
同 艺术	P 美N
同 指出	P X
同 中华人民共和国	P い地Hチ@M瓣
铜 浮雕	簧 BJ
童 帽	担 U
童 万	担 U
桶 价格	表 基
统 出笼	参 X泞
头 并	Y }
头 出门	Y X
头 出	Y X
头 发白	Y oフ
头 发表演说	Y o砗t弧
头 发电厂	Y oqt
头 发展	Y oi
头 发愣	Y oh
头 发	Y o
头 家畜	Y ab
头 佩	Y ㄘ
头 批发	Y уo
头 扑向	Y 汲V
头 扑	Y 汲
头 树荫下	Y 攫疆U
头 万	Y U
透 出	z X
秃 发	r o
突 爆发	 zo
突 并	 }
突 除此之外	 埃工Д~
突 发生	 oネ
突 发	 o
图 采取	瓜 蹦
图 出版	瓜 X
图 出现	瓜 X{
图 发现	瓜 o{
图 格	瓜 
图 共和国	瓜 @M瓣
图 技术	瓜 мN
图 先发制人	瓜 o瞍H
涂 层	额 h
涂 长	额 
涂 地上	额 aW
涂 粉	额 
涂 和	额 M
涂 划	额 购
涂 机器人	额 诀竟H
涂 技术	额 мN
涂 胶	额 溅
涂 军	额 x
涂 开发	额 }o
涂 粮食	额 鲁
涂 乱	额 睹
涂 面积	额 笨n
涂 面	额 
涂 农业	额 A~
涂 养	额 i
涂 有	额 Τ
涂 友	额 ね
涂 质量	额 借q
涂 中心	额 いみ
涂 种植	额 贺从
涂 资源	额 戈方
涂 自动	额 郯
屠 格	O 
土 并	g }
土 出口	g Xf
土 发牢骚	g oc奶
土 家族	g a壁
土 家	g a
土 伦	g 
土 默	g q
土 签署	g 帽p
土 签	g 帽
土 苏	g 默
土 有限公司	g Τそq
土 专家	g Ma
兔 开发	ㄟ }o
兔 帽	ㄟ U
团 采访	刮 蹦X
团 城市	刮 哎
团 出来	刮 Xㄓ
团 出席	刮 Xu
团 发出	刮 oX
团 共有	刮 @Τ
团 共	刮 @
团 树	刮 攫
团 演出	刮 tX
团 主席	刮 Du
团 专家	刮 Ma
腿 并	L }
腿 发抖	L oл
退 出租	h X
吞 并	] }
吞 国家	] 瓣a
拖 家	╈ a
托 哀	Λ s
托 按	Λ 
托 办理	Λ 快z
托 报	Λ 厨
托 本	Λ セ
托 毕	Λ 拨
托 闭幕	Λ 超辊
托 博士	Λ 痴h
托 不	Λ ぃ
托 参加	Λ 把[
托 产	Λ 玻
托 成立	Λ Θミ
托 出	Λ X
托 处理	Λ Bz
托 茨	Λ 
托 从事	Λ qㄆ
托 大使	Λ jㄏ
托 代表	Λ N
托 当年	Λ 讽~
托 到	Λ 
托 德	Λ w
托 的	Λ 
托 递交	Λ 患ユ
托 队	Λ 钉
托 对	Λ 癸
托 多	Λ h
托 儿	Λ ㄠ
托 尔	Λ 焊
托 法	Λ k
托 方便	Λ よK
托 方	Λ よ
托 菲	Λ 滇
托 费	Λ O
托 夫妇	Λ ひ包
托 夫	Λ ひ
托 弗	Λ ケ
托 赴	Λ u
托 副	Λ 捌
托 附近	Λ 
托 该	Λ 赣
托 改革	Λ э
托 高雄	Λ 蔼动
托 给	Λ 倒
托 供	Λ ㄑ
托 共产党	Λ @玻囊
托 广场	Λ s初
托 国内	Λ 瓣ず
托 国务院	Λ 瓣叭|
托 海	Λ 
托 邯	Λ 驼
托 和	Λ M
托 后	Λ 
托 乎	Λ G
托 回顾	Λ ^U
托 回	Λ ^
托 会见	Λ |ǎ
托 会议	Λ |某
托 基	Λ 膀
托 即将	Λ YN
托 季	Λ u
托 记者	Λ O
托 家人	Λ aH
托 家属	Λ a妮
托 加工	Λ [u
托 加号	Λ [腹
托 加	Λ [
托 检验	Λ 浪喷
托 将	Λ N
托 焦	Λ J
托 交手	Λ ユも
托 街道	Λ 刁D
托 结束	Λ 挡
托 今天	Λ さぱ
托 经过	Λ gL
托 就	Λ N
托 局	Λ Ы
托 举行	Λ |
托 军事	Λ xㄆ
托 卡	Λ d
托 科技	Λ 歆
托 科	Λ 
托 克拉	Λ J┰
托 克	Λ J
托 快艇	Λ е弗
托 拉	Λ ┰
托 来	Λ ㄓ
托 老人	Λ ρH
托 雷	Λ p
托 李	Λ 
托 里	Λ 
托 利	Λ Q
托 联合国	Λ pX瓣
托 连	Λ s
托 链	Λ 渺
托 了	Λ F
托 林业	Λ L~
托 林	Λ L
托 领导人	Λ 烩旧H
托 领导	Λ 烩旧
托 伦	Λ 
托 洛	Λ 
托 马	Λ 皑
托 毛	Λ を
托 门	Λ 
托 秘书	Λ 诞
托 姆	Λ i
托 木	Λ れ
托 那	Λ ê
托 纳	Λ 
托 南京	Λ nㄊ
托 尼	Λ ェ
托 努	Λ V
托 棋	Λ 囱
托 起	Λ _
托 前来	Λ eㄓ
托 亲友	Λ 克ね
托 亲	Λ 克
托 去	Λ h
托 权限	Λ v
托 人	Λ H
托 入学	Λ J厩
托 三	Λ T
托 商店	Λ 坝┍
托 商业	Λ 坝~
托 上学	Λ W厩
托 省	Λ 
托 事项	Λ ㄆ兜
托 是	Λ O
托 市	Λ カ
托 收	Λ Μ
托 书	Λ 
托 说	Λ 弧
托 斯	Λ 吹
托 思	Λ 
托 所	Λ ┮
托 他人	Λ LH
托 他	Λ L
托 她们	Λ o
托 台湾	Λ xW
托 提出	Λ 矗X
托 艇队	Λ 弗钉
托 艇	Λ 弗
托 同	Λ P
托 投资	Λ щ戈
托 娃	Λ 
托 瓦	Λ ニ
托 外交部长	Λ ~ユ场
托 王国	Λ 瓣
托 王	Λ 
托 问题	Λ 拜D
托 我们	Λ и
托 我	Λ и
托 武装部队	Λ Z杆场钉
托 向	Λ V
托 消息	Λ 
托 写给	Λ g倒
托 雪撬	Λ 撤祭
托 研究	Λ 悒s
托 也	Λ ]
托 一些	Λ @ㄇ
托 一	Λ @
托 伊	Λ レ
托 以	Λ H
托 议会	Λ 某|
托 有关	Λ Τ闽
托 幼	Λ ギ
托 于	Λ _
托 与	Λ P
托 预测	Λ w代
托 预计	Λ wp
托 运动	Λ B笆
托 运	Λ B
托 在	Λ b
托 政府	Λ F┎
托 政务	Λ F叭
托 之	Λ ぇ
托 中国	Λ い瓣
托 中	Λ い
托 重庆	Λ y
托 主持	Λ D
托 砖	Λ j
托 兹	Λ 
托 总理	Λ `z
托 总统	Λ `参
托 最近	Λ 程
托 作为	Λ @
托 娅	Λ 哉
脱 出来	叉 Xㄓ
脱 发白	叉 oフ
脱 发	叉 o
挖 采	 蹦
挖 出土	 Xg
挖 出	 X
挖 国家	 瓣a
挖 树	 攫
洼 发生	黑 oネ
娃 杯	 M
娃 推出	 崩X
瓦 格	ニ 
瓦 伦	ニ 
瓦 舍	ニ 
瓦 提出	ニ 矗X
瓦 宣布	ニ 钮
外 出版	~ X
外 出口	~ Xf
外 出血	~ X
外 发表	~ o
外 发送	~ oe
外 发行	~ o
外 反共	~ は@
外 公布	~ そガ
外 光束	~ 
外 家务	~ a叭
外 伦	~ 
外 使领馆	~ ㄏ烩]
外 凸出	~ YX
外 学术交流	~ 厩Nユy
外 学术界	~ 厩N
外 学术论文	~ 厩N阶ゅ
外 学术	~ 厩N
外 一小撮	~ @p技
外 植树	~ 从攫
外 专家	~ Ma
湾 并	W }
湾 出现	W X{
丸 有限公司	Y Τそq
完 大家	Ч ja
完 家常	Ч a`
完 手术	Ч もN
晚 播放	边 冀
晚 发表	边 o
晚 发动	边 o笆
晚 发生	边 oネ
晚 提出	边 矗X
晚 宣布	边 钮
皖 苏	p 默
婉 全家	胞 a
婉 婉	胞 胞
万 把	U р
万 宝	U _
万 变	U 跑
万 彬	U l
万 波	U i
万 博	U 痴
万 不得已	U ぃow
万 不	U ぃ
万 册	U U
万 产业	U 玻~
万 长	U 
万 城市	U 哎
万 城镇	U 奥
万 城	U 
万 成	U Θ
万 春	U K
万 次	U Ω
万 代	U N
万 担	U 踞
万 党员	U 囊
万 党	U 囊
万 道	U D
万 的	U 
万 滴	U w
万 地区	U a跋
万 点	U I
万 端	U 狠
万 多	U h
万 朵	U Ψ
万 儿童	U ㄠ担
万 儿	U ㄠ
万 方	U よ
万 份	U 
万 封	U 
万 伏	U ヱ
万 福	U 褐
万 富裕	U I肝
万 附近	U 
万 妇女	U 包k
万 干部	U F场
万 钢铁	U 葵K
万 港	U 翠
万 高	U 蔼
万 个	U 
万 各	U U
万 工人	U uH
万 工业	U u~
万 公斤	U そょ
万 公里	U そ
万 共青团	U @C刮
万 古	U j
万 观众	U [渤
万 海	U 
万 航	U 
万 毫	U @
万 好	U n
万 亨	U 
万 户	U め
万 辉	U 谨
万 计	U p
万 家门	U a
万 家人	U aH
万 家事	U aㄆ
万 家乡	U am
万 家	U a
万 加	U [
万 架次	U [Ω
万 间	U 丁
万 减	U 搭
万 件	U ン
万 杰	U 城
万 景	U 春
万 竞赛	U v辽
万 居民	U ~チ
万 具有	U ㄣΤ
万 卷	U 
万 军队	U x钉
万 军民	U xチ
万 棵	U 词
万 颗	U 聋
万 科威特人	U 飓炉SH
万 块	U 遏
万 劳动力	U 骋笆O
万 劳动	U 骋笆
万 劳力	U 骋O
万 里	U 
万 例	U ㄒ
万 立方	U ミよ
万 良	U }
万 两	U ㄢ
万 辆	U 进
万 岭	U 拉
万 鹿	U 忱
万 旅客	U 全
万 绿	U 厚
万 妈祖	U 洱
万 枚	U T
万 美国	U 瓣
万 蒙	U X
万 米	U μ
万 民	U チ
万 明	U 
万 名医	U W洛
万 名	U W
万 亩	U a
万 木	U れ
万 尼	U ェ
万 宁	U 圭
万 农村	U A
万 农户	U Aめ
万 农民	U Aチ
万 农	U A
万 女	U k
万 诺	U 空
万 匹	U で
万 偏	U 熬
万 票	U 布
万 贫困	U hx
万 平方公里	U キよそ
万 瓶	U ~
万 千瓦	U dニ
万 千	U d
万 青年	U C~
万 青少年	U Cぶ~
万 顷	U 臣
万 泉	U u
万 群众	U s渤
万 人口	U Hf
万 人民币	U Hチ刽
万 人民	U Hチ
万 人心	U Hみ
万 日元	U らじ
万 润	U 柬
万 赛	U 辽
万 山	U s
万 商	U 坝
万 上海	U W
万 上空	U W
万 少年	U ぶ~
万 少数民族	U ぶ计チ壁
万 少	U ぶ
万 绍	U 残
万 生	U ネ
万 失学	U ア厩
万 石	U ホ
万 世世代代	U @@NN
万 事	U ㄆ
万 是	U O
万 市长	U カ
万 视	U 跌
万 寿	U 关
万 树	U 攫
万 双	U 蛮
万 说	U 弧
万 嗣	U 多
万 苏联	U 默p
万 台	U x
万 套	U M
万 提	U 矗
万 通	U q
万 头	U Y
万 退休者	U hヰ
万 万	U U
万 维生	U 蝴ネ
万 乡镇	U m马
万 祥	U 不
万 项	U 兜
万 谢	U 谅
万 新	U s
万 兴	U 砍
万 行	U 
万 言	U ē
万 应	U 莱
万 优秀	U uq
万 游	U 村
万 友	U ね
万 余	U E
万 源	U 方
万 越南	U Vn
万 载	U 更
万 在	U b
万 增加	U W[
万 盏	U 辐
万 章	U 彻
万 张	U i
万 兆	U 
万 支	U や
万 职	U 戮
万 只	U u
万 中	U い
万 种	U 贺
万 众	U 渤
万 株	U 
万 壮	U Ё
万 状	U 
万 自然	U 鄣M
万 字	U r
万 壑	U 坤
万 琦	U a
万 祺	U R
万 铢	U 凰
万 籁	U 牛
汪 家	L a
汪 指出	L X
王 昂	 
王 杯	 M
王 漫	 憨
王 佩	 ㄘ
王 树	 攫
王 万	 U
网 并	呼 }
网 发电	呼 oq
网 密布	呼 Kガ
网 树木	呼 攫れ
往 出事地点	┕ XㄆaI
往 出	┕ X
往 国家	┕ 瓣a
往 家	┕ a
旺 发表	 o
旺 趋向	 镣V
望 并	辨 }
望 采	辨 蹦
望 出口	辨 Xf
望 出现	辨 X{
望 出	辨 X
望 大家	辨 ja
望 派出所	辨 ％X┮
望 签署	辨 帽p
望 治疗	辨 v励
望 走出	辨 ǐX
忘 当年	а 讽~
忘 扶助	а нU
忘 共产党	а @玻囊
威 格	 
韦 布	 ガ
韦 格	 
韦 家	 a
韦 托	 Λ
韦 政府发言人	 F┎oēH
围 并	瞅 }
围 出	瞅 X
围 堤	瞅 出
围 共有	瞅 @Τ
围 之外	瞅 ぇ~
唯 国家	斑 瓣a
为 背景	 I春
为 扁圆形	 蠖戋
为 并	 }
为 不结盟国家	 ぃ挡幅瓣a
为 布	 ガ
为 采访	 蹦X
为 铲	 藐
为 撤出	 MX
为 城市	 哎
为 出版	 X
为 出发点	 XoI
为 出国	 X瓣
为 出口	 Xf
为 出席	 Xu
为 出	 X
为 大家	 ja
为 发达	 oF
为 发射	 og
为 发音	 o
为 发展	 oi
为 发	 o
为 匪	 
为 丰	 伦
为 扶持	 н
为 扶植	 н从
为 扶	 н
为 哥伦比亚	 舡郅瘿
为 共产党员	 @玻囊
为 共产主义	 @玻Dq
为 共和国	 @M瓣
为 共识	 @醚
为 共同目标	 @Pヘ夹
为 共同	 @P
为 国家元首	 瓣aじ
为 国家	 瓣a
为 合格	 X
为 画家	 ea
为 挤出	 澜X
为 技术	 мN
为 家常便饭	 a`K逗
为 家庭教育	 ax毙|
为 家庭	 ax
为 家务事	 a叭ㄆ
为 家乡	 am
为 家用	 aノ
为 家	 a
为 坚持	 绊
为 坚决	 绊M
为 坚守	 绊u
为 坚	 绊
为 江苏	 磕
为 杰出	 城X
为 结婚	 挡B
为 紧张	 候i
为 剧作家	 @@a
为 开发	 }o
为 洛阳	 ザ
为 明显	 陪
为 母校	 ダ
为 恼	 o
为 农家	 Aa
为 扑灭	 汲防
为 千千万万	 ddUU
为 签名	 帽W
为 签署	 帽p
为 签	 帽
为 秋	 
为 石油输出国组织	 ホo块X瓣舱麓
为 收发	 Μo
为 树立	 攫ミ
为 水力发电	 簸Ooq
为 苏联	 默p
为 苏	 默
为 特殊	 S
为 跳板	 铬O
为 突出	 馥X
为 挽救	 颈
为 万	 U
为 未婚	 ゼB
为 武术	 ZN
为 西藏	 杪
为 西欧国家	 杓诎戤a
为 学术	 厩N
为 医疗	 洛励
为 依托	 ㄌΛ
为 艺术	 美N
为 亿万	 货U
为 预测	 w代
为 造纸厂	 y燃t
为 战斗	 驹矮
为 植树	 从攫
为 治疗	 v励
为 中华人民共和国	 い地Hチ@M瓣
为 中坚	 い绊
为 主席团	 Du刮
为 主席	 Du
为 作家	 @a
维 采	蝴 蹦
维 澄	蝴 坚
维 出席	蝴 Xu
维 发表	蝴 o
维 共和国	蝴 @M瓣
维 苏	蝴 默
维 托	蝴 Λ
委 颁发	e {o
委 采纳	e 蹦
委 采取	e 蹦
委 串	e 
委 当年	e 讽~
委 发布	e oガ
委 发出	e oX
委 扶	e н
委 共同	e @P
委 共	e @
委 会签	e |帽
委 技术	e мN
委 坚持	e 绊
委 坚定不移	e 绊wぃ簿
委 坚决	e 绊M
委 签	e 帽
委 树	e 攫
委 苏	e 默
委 提出	e 矗X
委 托	e Λ
委 万国	e U瓣
委 指出	e X
委 主席	e Du
委 专门	e M
委 转发	e 锣o
委 作出	e @X
伟 出	岸 X
伟 发明	岸 o
伟 丰	岸 伦
伟 伦	岸 
伪 出动	鞍 X笆
未 卜	ゼ R
未 撤出	ゼ MX
未 出版	ゼ X
未 出场	ゼ X初
未 出现	ゼ X{
未 出	ゼ X
未 发出	ゼ oX
未 发动	ゼ o笆
未 发生	ゼ oネ
未 发现	ゼ o{
未 发	ゼ o
未 结婚	ゼ 挡B
未 开采	ゼ }蹦
未 卖出	ゼ 芥X
未 明显	ゼ 陪
未 提出	ゼ 矗X
未 意识到	ゼ N醚
未 正式宣布	ゼ タΑ钮
未 作出	ゼ @X
味 秋	 
味 仔细	 J灿
胃 出血	G X
魏 格	Q 
魏 家	Q a
位 采	 蹦
位 城市	 哎
位 出版商	 X┌
位 出门	 X
位 达赖喇嘛	 F苦斥估
位 戴眼镜	 拦泊描
位 发言人	 oēH
位 共产党员	 @玻囊
位 共和国	 @M瓣
位 画家	 ea
位 家长	 a
位 家庭教育	 ax毙|
位 家	 a
位 紧张	 候i
位 经济学家	 g蕾厩a
位 科学家	 炀钱a
位 可敬	 iq
位 课题	 揭D
位 老资格	 ρ戈
位 妈妈	 洱洱
位 名家	 Wa
位 女作家	 k@a
位 企业家	 ~a
位 亲戚	 克杯
位 散布	 床ガ
位 实业家	 龟~a
位 书法家	 血ka
位 术	 N
位 数学家	 计厩a
位 苏丹	 默う
位 苏联	 默p
位 挑战者	 D驹
位 艺术家	 美Na
位 艺术	 美N
位 音乐家	 导之a
位 哲学家	 蹙钱a
位 政府发言人	 F┎oēH
位 中坚	 い绊
位 主席	 Du
位 专家	 Ma
位 资格	 戈
位 作家	 @a
谓 雅俗共赏	孔 懂U@洁
谓 艺术	孔 美N
卫 国家	矫 瓣a
温 逼	放 G
温 布	放 ガ
温 焊接	放 k钡
温 家	放 a
温 情况	放 薄p
文 并	ゅ }
文 布	ゅ ガ
文 采	ゅ 蹦
文 出版社	ゅ X┆
文 出版	ゅ X
文 家	ゅ a
文 提出	ゅ 矗X
闻 城市	D 哎
闻 家	D a
问 出来	拜 Xㄓ
问 大家	拜 ja
问 一共	拜 @@
翁 伯	 B
翁 不	 ぃ
翁 达	 F
翁 的	 
翁 地位	 a
翁 对	 癸
翁 多	 h
翁 福	 褐
翁 瓜	 ナ
翁 还	 临
翁 获得	 莉o
翁 建议	 啬
翁 今天	 さぱ
翁 精神	 弘
翁 劳动	 骋笆
翁 内	 ず
翁 强调	 j秸
翁 态度	 A
翁 意识	 N醚
翁 源	 方
翁 责任感	 dヴP
翁 振	 
翁 之	 ぇ
翁 只有	 uΤ
翁 作用	 @ノ
挝 提出	锯 矗X
我 并	и }
我 采访	и 蹦X
我 出生	и Xネ
我 出	и X
我 当年	и 讽~
我 发财	и o]
我 发现	и o{
我 发展	и oi
我 扶持	и н
我 扶	и н
我 共同	и @P
我 欢欣鼓舞	и wY躬R
我 回家	и ^a
我 家属	и a妮
我 家	и a
我 坚持	и 绊
我 坚信	и 绊H
我 解释	и 秆睦
我 紧张	и 候i
我 妈妈	и 洱洱
我 拿出	и 偿X
我 能够	и 喟
我 签	и 帽
我 亲戚	и 克杯
我 全家	и a
我 舍	и 
我 手背	и もI
我 说出	и 弧X
我 思潮	и 浼
我 掏出	и 鼻X
我 挑战	и D驹
我 托	и Λ
我 种树	и 贺攫
我 走出	и ǐX
沃 发展	U oi
沃 格	U 
沃 舍	U 
乌 苏	Q 默
乌 托	Q Λ
乌 溪	Q 匪
污 专家	γ Ma
屋 塌	 厄
无 出路	L X隔
无 发展	L oi
无 复发	L _o
无 迹	L 格
无 家禽	L aV
无 建树	L 鼐
无 明显	L 陪
无 树	L 攫
无 特殊	L S
无 校舍	L 摘
无 幽默	L 绽q
吴 家	d a
吴 坚	d 绊
吴 敬	d q
吴 树	d 攫
武 并	Z }
武 漫	Z 憨
五 家	き a
舞 艺术	R 美N
伍 家	ヮ a
伍 默	ヮ q
雾 弥漫	铭 辣憨
物 背景	 I春
物 出版社	 X┆
物 出版	 X
物 出口	 Xf
物 出	 X
物 丰	 伦
物 价格	 基
物 坚固	 绊T
务 并	叭 }
务 发明	叭 o
务 情况	叭 薄p
务 限额	叭 B
务 意识	叭 N醚
务 主席	叭 Du
务 专家	叭 Ma
悟 出	 X
西 出	 X
西 发现	 o{
西 发	 o
西 丰	 伦
西 格	 
西 家	 a
西 罗布	 霉ガ
西 苏	 默
西 提出	 矗X
西 托	 Λ
西 翁	 
西 英格兰	 ^婺
西 指出	 X
吸 疗法	l 励k
锡 提出	奎 矗X
稀 树木	} 攫れ
稀 树	} 攫
希 格	 
夕 发表	i o
溪 城	匪 
溪 冲	匪 R
溪 到	匪 
溪 等	匪 单
溪 地区	匪 a跋
溪 妇女	匪 包k
溪 钢铁	匪 葵K
溪 哥哥	匪 舡
溪 故乡	匪 Gm
溪 观看	匪 [
溪 河	匪 e
溪 湖	匪 打
溪 江	匪 
溪 就是	匪 NO
溪 卷	匪 
溪 看到	匪 莰
溪 冷水	匪 N
溪 林业	匪 L~
溪 龙门	匪 s
溪 农村	匪 A
溪 清水	匪 M
溪 区	匪 跋
溪 泉	匪 u
溪 市政府	匪 カF┎
溪 市	匪 カ
溪 水	匪 
溪 尾	匪 Ю
溪 卫	匪 矫
溪 五	匪 き
溪 县	匪 郡
溪 乡	匪 m
溪 也	匪 ]
溪 峪	匪 n
溪 站	匪 
溪 镇	匪 马
溪 阻隔	匪 j
溪 溥	匪 妨
席 爆发	u zo
媳 背	@ I
媳 情况	@ 薄p
喜 当年	尺 讽~
喜 降雨	尺 矮B
洗 发	~ o
系 并	t }
系 采访	t 蹦X
系 采取	t 蹦
系 出现	t X{
系 发表声明	t o砹n
系 发生	t oネ
系 发展	t oi
系 国家	t 瓣a
系 极为	t 伐
系 坚持	t 绊
系 紧张	t 候i
系 美术	t N
系 能够	t 喟
系 趋向	t 镣V
系 融洽	t 磕
系 提出	t 矗X
系 万	t U
系 专家	t Ma
系 作出	t @X
戏 木雕	栏 れJ
虾 之外	郊 ぇ~
下 采掘	U 蹦备
下 采取	U 蹦
下 采	U 蹦
下 撤出	U MX
下 抽出	U ┾X
下 出笼	U X泞
下 出现	U X{
下 出	U X
下 动手术	U 笆もN
下 发表	U o
下 发动	U o笆
下 发放	U o
下 发给	U o倒
下 发挥	U o揣
下 发射	U og
下 发生	U oネ
下 发展	U oi
下 发	U o
下 格外	U 妤~
下 公布	U そガ
下 共同努力	U @PVO
下 挤出	U 澜X
下 家事	U aㄆ
下 坚持	U 绊
下 坚实	U 绊龟
下 阶段	U 顶q
下 棉裤	U 粗壳
下 能够	U 喟
下 签署	U 帽p
下 签	U 帽
下 树立	U 攫ミ
下 树	U 攫
下 竖起	U 捷_
下 塌	U 厄
下 提出	U 矗X
下 宣布	U 钮
下 茁壮成长	U _ЁΘ
下 仔细	U J灿
下 自家	U 郛a
下 作出	U @X
下 箸	U 烘
夏 家	L a
夏 秋	L 
先 报名	 厨W
先 城市	 哎
先 发现	 o{
先 发展	 oi
先 发	 o
先 回家	 ^a
先 家	 a
先 开发	 }o
先 治疗	 v励
鲜 驳斥	A 婚ジ
鲜 撤出	A MX
鲜 出动	A X笆
鲜 出售	A X扳
鲜 出席	A Xu
鲜 革命家	A 博Ra
鲜 共	A @
鲜 国家	A 瓣a
鲜 果树	A G攫
鲜 技术	A мN
鲜 坚持	A 绊
鲜 进出口	A iXf
鲜 开发	A }o
鲜 乒乓球	A モャy
鲜 签	A 帽
鲜 提出	A 矗X
鲜 宣布	A 钮
鲜 艺术家	A 美Na
鲜 战斗机	A 驹矮诀
弦 的	┒ 
弦 之	┒ ぇ
显 技术	陪 мN
显 突出	陪 馥X
险 并	I }
现 出售	{ X扳
现 发布	{ oガ
现 共	{ @
现 国家	{ 瓣a
现 千千万万	{ ddUU
现 已出版	{ wX
献 出	m X
县 百万吨	郡 κU痉
县 布	郡 ガ
县 采访	郡 蹦X
县 采取	郡 蹦
县 抽出	郡 ┾X
县 出动	郡 X笆
县 出土	郡 Xg
县 出现	郡 X{
县 出	郡 X
县 发出	郡 oX
县 发生	郡 oネ
县 发现	郡 o{
县 发展	郡 oi
县 扶	郡 н
县 概况	郡 阀p
县 共和	郡 @M
县 共有	郡 @Τ
县 共	郡 @
县 黑板	郡 堵O
县 坚持	郡 绊
县 开发	郡 }o
县 客家	郡 犬a
县 老家	郡 ρa
县 帽子	郡 Ul
县 民族学	郡 チ壁厩
县 拿出	郡 偿X
县 乒乓球	郡 モャy
县 签	郡 帽
县 秋	郡 
县 肉类	郡 ψ摸
县 提出	郡 矗X
县 体验	郡 砰喷
县 田家	郡 バa
县 跳出	郡 铬X
县 万人	郡 UH
县 万	郡 U
县 校舍	郡 摘
县 演出	郡 tX
县 遭受	郡 D
县 造纸厂	郡 y燃t
县 之外	郡 ぇ~
县 植树	郡 从攫
县 作出	郡 @X
宪 出生	舅 Xネ
限 国家	 瓣a
线 并	u }
线 出	u X
线 发动攻势	u o笆ю墩
线 奋斗	u 灸矮
线 共有	u @Τ
线 共	u @
线 婉	u 胞
线 植树	u 从攫
线 资格	u 戈
线 作出	u @X
相 背	 I
相 发起	 o_
相 扶	 н
相 掏出	 鼻X
相 违背	 HI
香 并	 }
香 发酵	 o幻
香 格	 
香 扑鼻	 汲惑
香 树	 攫
香 溪	 匪
湘 家	答 a
乡 报名	m 厨W
乡 出	m X
乡 串	m 
乡 发送	m oe
乡 发现	m o{
乡 共有	m @Τ
乡 共	m @
乡 家庭	m ax
乡 敬	m q
乡 派出所	m ％X┮
乡 邢	m ǚ
祥 出差	不 Xt
祥 当年	不 讽~
祥 斗	不 矮
祥 家庭	不 ax
祥 家乡	不 am
祥 家	不 a
祥 坚持	不 绊
祥 艺术	不 美N
祥 指出	不 X
想 采访	Q 蹦X
想 澄清	Q 坚M
想 发财	Q o]
想 国家	Q 瓣a
想 挤出	Q 澜X
想 家乡	Q am
想 开发	Q }o
想 跑出	Q ]X
想 挑战	Q D驹
响 喇叭	T 斥z
享 天伦之乐	ㄉ ぱ郅Ъ
项 杯	兜 M
项 采取	兜 蹦
项 斗争	兜 矮
项 发明	兜 o
项 发展	兜 oi
项 丰	兜 伦
项 扶持	兜 н
项 扶	兜 н
项 公报	兜 そ厨
项 共同声明	兜 @Pn
项 共同研究	兜 @P悒s
项 共同	兜 @P
项 共	兜 @
项 国家	兜 瓣a
项 极为	兜 伐
项 技术	兜 мN
项 决议草案	兜 M某螽
项 开发	兜 }o
项 课题	兜 揭D
项 联合公报	兜 pXそ厨
项 农家庭院	兜 Aax|
项 千秋	兜 d
项 签	兜 帽
项 苏	兜 默
项 特殊	兜 S
项 突出	兜 馥X
项 限额	兜 B
项 协议草案	兜 竽朝螽
项 宣布	兜 钮
项 学术	兜 厩N
项 预测	兜 w代
项 支出	兜 やX
项 作出	兜 @X
像 出版社	钩 X┆
向 巴格达	V ぺ婀F
向 布	V ガ
向 城市	V 哎
向 出口	V Xf
向 出事地点	V XㄆaI
向 出席	V Xu
向 大家	V ja
向 顶风	V 郴
向 发表	V o
向 发达	V oF
向 发生	V oネ
向 发展	V oi
向 发	V o
向 丰	V 伦
向 复苏	V _默
向 哥伦比亚	V 舡郅瘿
向 共产党	V @玻囊
向 国家	V 瓣a
向 化妆品	V てЗ~
向 技术	V мN
向 家庭	V ax
向 坚定	V 绊w
向 坚	V 绊
向 敬	V q
向 喀布尔	V 池ガ焊
向 开发	V }o
向 卢布	V cガ
向 农家	V Aa
向 佩	V ㄘ
向 亲戚	V 克杯
向 苏丹	V 默う
向 苏联	V 默p
向 苏州	V 默{
向 苏	V 默
向 万	V U
向 西藏	V 杪
向 艺术家	V 美Na
向 易北河	V 謦_e
向 遭受	V D
向 战斗	V 驹矮
向 主席台	V Dux
向 总公司	V `そq
象 出版	H X
象 出口	H Xf
象 当年	H 讽~
象 发达	H oF
象 发	H o
象 分析家	H だRa
象 扶	H н
象 格	H 
象 共产党	H @玻囊
象 国家	H 瓣a
象 焊接	H k钡
象 技术	H мN
象 久别重逢	H [O{
象 西藏	H 杪
象 一家人	H @aH
象 珍惜	H 帽
销 出口	P Xf
销 出去	P Xh
销 出现	P X{
销 出	P X
销 额	P B
销 金额	P 髅B
销 情况	P 薄p
销 苏联	P 默p
晓 佩	惧 ㄘ
小 扁担	p 缶
小 城市	p 哎
小 额	p B
小 发	p o
小 规格	p W
小 国家	p 瓣a
小 画家	p ea
小 家境	p a挂
小 家庭	p ax
小 家用	p aノ
小 家	p a
小 敬	p q
小 开发	p }o
小 树立	p 攫ミ
小 树苗	p 攫]
小 树	p 攫
小 托儿所	p Λㄠ┮
小 医疗	p 洛励
小 音乐家	p 导之a
小 幽默	p 绽q
校 采取	 蹦
校 出版社	 X┆
校 发展	 oi
校 共有	 @Τ
校 共	 @
校 果树	 G攫
校 阶段	 顶q
校 开发	 }o
校 西藏	 杪
校 专家	 Ma
肖 树	v 攫
肖 梓树	v 标攫
笑 走出	 ǐX
效 技术	 мN
效 课题	 揭D
效 明显	 陪
效 突出	 馥X
些 国家	ㄇ 瓣a
些 突出	ㄇ 馥X
鞋 出售	c X扳
鞋 帽	c U
鞋 万	c U
协 杯	 M
协 扶	 н
协 公布	 そガ
协 共同	 @P
协 共有	 @Τ
协 共	 @
协 技术	 мN
协 腾出	 乃X
协 提出	 矗X
协 西藏	 杪
协 主席	 Du
协 专门委员会	 Me|
协 专门	 M
携 扶起	拟 н_
写 出版	g X
写 出来	g Xㄓ
写 出	g X
写 家信	g aH
写 完毕	g Ч拨
械 技术	瘪 мN
械 针布	瘪 wガ
懈 斗争	居 矮
泄 出	n X
谢 发明	谅 o
谢 共产党	谅 @玻囊
谢 万	谅 U
锌 并	N }
辛 格	ǒ 
新 背	s I
新 并	s }
新 布	s ガ
新 采	s 蹦
新 出版	s X
新 出土	s Xg
新 出现	s X{
新 发电	s oq
新 发明	s o
新 发生	s oネ
新 发现	s o{
新 发行	s o
新 发展	s oi
新 发	s o
新 丰	s 伦
新 风格	s 樊
新 格局	s 妲
新 公布	s そガ
新 国家	s 瓣a
新 技术	s мN
新 家具	s aㄣ
新 建树	s 鼐
新 阶段	s 顶q
新 结婚	s 挡B
新 开发	s }o
新 科学家	s 炀钱a
新 课题	s 揭D
新 裤	s 壳
新 劳工部长	s 骋u场
新 疗法	s 励k
新 楼房	s 加┬
新 帽	s U
新 千秋	s d
新 签署	s 帽p
新 签	s 帽
新 情况	s 薄p
新 趋向	s 镣V
新 手术	s もN
新 树	s 攫
新 思潮	s 浼
新 提出	s 矗X
新 挑战	s D驹
新 西藏	s 杪
新 宪法草案	s 舅k螽
新 限额	s B
新 校舍	s 摘
新 形态	s 魏A
新 选出	s 匡X
新 医疗	s 洛励
新 艺术	s 美N
新 主席	s Du
心 斗	み 矮
心 隔热板	み j荐O
心 扑	み 汲
心 树	み 攫
心 研究出	み 悒sX
信 并	H }
信 发展	H oi
信 发	H o
信 共同	H @P
信 共有	H @Τ
信 国家	H 瓣a
信 技术	H мN
信 杰出	H 城X
信 托	H Λ
信 有限公司	H Τそq
兴 杯	砍 M
兴 并	砍 }
兴 当年	砍 讽~
兴 格	砍 
型 并	 }
型 城市	 哎
型 电焊	 qk
型 发动机	 o笆诀
型 发展	 oi
型 技术	 мN
型 家庭	 ax
型 开发	 }o
型 学术	 厩N
型 战斗机	 驹矮诀
形 突出	 馥X
邢 崇	ǚ R
邢 春	ǚ K
邢 村	ǚ 
邢 德	ǚ w
邢 芬	ǚ 
邢 耿	ǚ 
邢 贵	ǚ Q
邢 丽	ǚ R
邢 台	ǚ x
邢 相比	ǚ 郅
邢 雁	ǚ 董
邢 冶金	ǚ M
邢 诒	ǚ 圻
行 采访	 蹦X
行 出席	 Xu
行 发表	 o
行 发出	 oX
行 发放	 o
行 共	 @
行 迹	 格
行 开发	 }o
行 漫	 憨
行 情况	 薄p
行 树	 攫
行 提出	 矗X
行 涂料	 额
行 万	 U
行 艺术	 美N
行 之外	 ぇ~
行 指出	 X
行 专家	 Ma
行 作出	 @X
杏 出	 X
杏 树	 攫
性 并	┦ }
性 采用	┦ 蹦ノ
性 痴呆	┦ 扶b
性 出血	┦ X
性 发电	┦ oq
性 发给	┦ o倒
性 发	┦ o
性 果树	┦ G攫
性 技术	┦ мN
性 坚	┦ 绊
性 开采	┦ }蹦
性 开发	┦ }o
性 切除术	┦ ち埃N
性 提出	┦ 矗X
性 体验	┦ 砰喷
性 文章	┦ ゅ彻
性 武术	┦ ZN
性 学术	┦ 厩N
性 一下子	┦ @Ul
性 艺术	┦ 美N
性 蒸馏	┦ ]H
性 支出	┦ やX
胸 手术	 もN
匈 国家银行	I 瓣a蝗
匈 坚持	I 绊
匈 签	I 帽
匈 情况	I 薄p
匈 苏	I 默
修 发	 o
修 家	 a
修 校舍	 摘
锈 状况	拿 p
秀 发	q o
秀 家	q a
秀 提出	q 矗X
秀 邢	q ǚ
需 采用	惠 蹦ノ
需 技术	惠 мN
需 手术	惠 もN
虚 发	店 o
须 采取	斗 蹦
徐 采	} 蹦
徐 发	} o
徐 家法	} ak
徐 家	} a
许 发生	\ oネ
许 家	\ a
叙 伦	痹 
序 采用	 蹦ノ
畜 技术	b мN
畜 舍	b 
绪 出现	狐 X{
续 签	尿 帽
轩 指出	a X
宣 采取	 蹦
宣 佩	 ㄘ
选 采用	匡 蹦ノ
选 当年	匡 讽~
选 共	匡 @
选 国家	匡 瓣a
选 家	匡 a
选 名额	匡 WB
选 平常	匡 キ`
学 出现	厩 X{
学 发起	厩 o_
学 发展	厩 oi
学 共	厩 @
学 果树	厩 G攫
学 技术	厩 мN
学 家	厩 a
学 指出	厩 X
学 专家	厩 Ma
穴 治疗	マ v励
雪 杯	撤 M
雪 并	撤 }
雪 采访	撤 蹦X
雪 出来	撤 Xㄓ
雪 电影艺术	撤 qv美N
雪 雕	撤 J
雪 斗	撤 矮
雪 引出	撤 まX
雪 状况	撤 p
血 斗争	 矮
血 千秋	 d
勋 发出	吃 oX
熏 得	饫 o
熏 黑	饫 堵
熏 昏	饫 
熏 火	饫 
熏 染	饫 V
熏 陶	饫 吵
熏 吸	饫 l
熏 心	饫 み
熏 鱼	饫 辰
熏 蒸	饫 ]
旬 撤出	Ο MX
旬 发生	Ο oネ
旬 发现	Ο o{
旬 坚持	Ο 绊
旬 老翁	Ο ρ
旬 明显	Ο 陪
旬 宣布	Ο 钮
旬 专门	Ο M
训 出	V X
训 技术管理	V мN恨z
训 技术人员	V мNH
训 技术	V мN
训 敬	V q
训 秋	V 
训 完毕	V Ч拨
训 未婚	V ゼB
训 西藏	V 杪
训 专家	V Ma
讯 扶老携幼	T нρ拟ギ
逊 敦促	还 窗P
压 发生	溃 oネ
牙 坚持	 绊
哑 痴呆	白 扶b
亚 并	ㄈ }
亚 布	ㄈ ガ
亚 出席	ㄈ Xu
亚 发誓	ㄈ o}
亚 公共工程	ㄈ そ@u{
亚 共和国	ㄈ @M瓣
亚 共	ㄈ @
亚 国家元首	ㄈ 瓣aじ
亚 国家	ㄈ 瓣a
亚 坚决	ㄈ 绊M
亚 摩托车	ㄈ 集Λó
亚 托管	ㄈ Λ恨
亚 宪法草案	ㄈ 舅k螽
亚 宣布独立	ㄈ 钮Wミ
亚 主席	ㄈ Du
亚 专家	ㄈ Ma
亚 作出	ㄈ @X
烟 出口	废 Xf
烟 斗	废 矮
烟 价格	废 基
烟 弥漫	废 辣憨
烟 熏	废 饫
烟 有限公司	废 Τそq
盐 城市	Q 哎
严 家	Y a
研 共	 @
研 技术	 мN
研 阶段	 顶q
研 开发	 }o
研 课题	 揭D
研 学术	 厩N
研 治疗	 v励
岩 出来	━ Xㄓ
岩 顶峰	━ 郴p
岩 遗迹	━ 框格
言 出	ē X
言 情况	ē 薄p
言 融洽	ē 磕
言 说出	ē 弧X
言 提出	ē 矗X
言 踊跃	ē 裤D
言 预测	ē w代
言 指出	ē X
言 仔细	ē J灿
阎 树	F 攫
炎 发	 o
炎 提出	 矗X
眼 采掘	泊 蹦备
眼 漫	泊 憨
演 阶段	t 顶q
燕 杯	P M
燕 发	P o
彦 出席	 Xu
验 出口	喷 Xf
央 民族学	ァ チ壁厩
秧 技术	 мN
杨 发	法 o
杨 家	法 a
杨 坚	法 绊
杨 树林	法 攫L
杨 树苗	法 攫]
杨 树	法 攫
杨 主席	法 Du
杨 总工程师	法 `u{v
扬 当年	喘 讽~
扬 斗	喘 矮
扬 风格	喘 樊
扬 共产主义	喘 @玻Dq
扬 树	喘 攫
扬 托	喘 Λ
扬 指出	喘 X
羊 出口	ο Xf
羊 出	ο X
羊 技术	ο мN
羊 移植	ο 簿从
洋 万	v U
阳 出版社	锭 X┆
阳 出租	锭 X
阳 发现	锭 o{
阳 发行	锭 o
阳 老家	锭 ρa
氧 技术	 мN
养 出	i X
养 技术	i мN
样 板	妓 O
样 发展	妓 oi
样 丰	妓 伦
样 共产党	妓 @玻囊
样 解释	妓 秆睦
样 思潮	妓 浼
样 优异	妓 u钵
样 走下	妓 ǐU
邀 出席	淋 Xu
邀 国家	淋 瓣a
腰 板	y O
瑶 家	航 a
遥 万	换 U
窑 采用	` 蹦ノ
药 杯	媚 M
药 并	媚 }
药 技术	媚 мN
药 开发	媚 }o
药 疗	媚 励
药 情况	媚 薄p
药 有限公司	媚 Τそq
药 治疗	媚 v励
药 专家	媚 Ma
要 逼	n G
要 采取	n 蹦
要 超额	n WB
要 承袭	n ┯脓
要 出嫁	n X儿
要 出面	n X
要 出售	n X扳
要 出席	n Xu
要 出	n X
要 打消	n ゴ
要 大家	n ja
要 敦促	n 窗P
要 发表	n o
要 发动	n o笆
要 发挥作用	n o揣@ノ
要 发挥	n o揣
要 发生	n oネ
要 发送	n oe
要 发展	n oi
要 发	n o
要 分娩	n だY
要 奋斗	n 灸矮
要 丰	n 伦
要 扶持	n н
要 付出	n IX
要 格外	n 妤~
要 公布	n そガ
要 共同努力	n @PVO
要 共同	n @P
要 国家	n 瓣a
要 坚持不懈	n 绊ぃ居
要 坚持	n 绊
要 坚定不移	n 绊wぃ簿
要 坚定	n 绊w
要 坚决	n 绊M
要 坚守	n 绊u
要 坚信	n 绊H
要 救出	n 毕X
要 开发	n }o
要 流下	n yU
要 明显	n 陪
要 拿出	n 偿X
要 签署	n 帽p
要 舍	n 
要 树立	n 攫ミ
要 塌	n 厄
要 提出	n 矗X
要 跳出	n 铬X
要 挺身而出	n 绩τX
要 突出	n 馥X
要 推出	n 崩X
要 退出	n hX
要 挽救	n 颈
要 严格	n Y
要 有系统	n Τt参
要 远行	n 环
要 遭受	n D
要 找出	n тX
要 珍惜	n 帽
要 植树	n 从攫
要 指出	n X
要 种树	n 贺攫
要 仔细	n J灿
耀 指出	模 X
耶 出	C X
耶 宣布	C 钮
爷 采	份 蹦
爷 家	份 a
爷 默默	份 qq
野 婚	偿 B
也 背	] I
也 别具一格	] Oㄣ@
也 并	] }
也 采取	] 蹦
也 超出	] WX
也 出版	] X
也 出兵	] XL
也 出奇	] X_
也 出席	] Xu
也 出现	] X{
也 出	] X
也 独树一帜	] W攫@m
也 敦促	] 窗P
也 发表声明	] o砹n
也 发表	] o
也 发愁	] oT
也 发放	] o
也 发给	] o倒
也 发挥	] o揣
也 发起	] o_
也 发人深思	] oH`
也 发生	] oネ
也 发现	] o{
也 发展	] oi
也 发	] o
也 放出	] 癀X
也 付出	] IX
也 激发	] Eo
也 极为	] 伐
也 看出	] 荪X
也 露出	] SX
也 明显	] 陪
也 拿出	] 偿X
也 能够	] 喟
也 喷出	] QX
也 签署	] 帽p
也 签	] 帽
也 说不出来	] 弧ぃXㄓ
也 提出	] 矗X
也 跳出	] 铬X
也 推出	] 崩X
也 违背	] HI
也 违反	] Hは
也 形态	] 魏A
也 宣布	] 钮
也 严格	] Y
也 已出版	] wX
也 踊跃	] 裤D
也 指出	] X
也 专门	] M
也 作出	] @X
业 杯	~ M
业 布	~ ガ
业 出口	~ Xf
业 出现	~ X{
业 发达	~ oF
业 发生	~ oネ
业 发展	~ oi
业 扶持	~ н
业 复苏	~ _默
业 共有	~ @Τ
业 技术	~ мN
业 家	~ a
业 开发	~ }o
业 情况	~ 薄p
业 提出	~ 矗X
业 托	~ Λ
业 有限公司	~ Τそq
业 遭受	~ D
叶 出版	腑 X
叶 佩	腑 ㄘ
叶 树	腑 攫
夜 出	] X
夜 家属	] a妮
一 板车	@ Oó
一 薄板	@ 痢O
一 杯	@ M
一 背景	@ I春
一 并	@ }
一 布袋	@ ガU
一 布置	@ ガm
一 草案	@ 螽
一 铲	@ 藐
一 城市	@ 哎
一 出版	@ X
一 出场	@ X初
一 出口	@ Xf
一 出来	@ Xㄓ
一 出门	@ X
一 出人意外	@ XHN~
一 出生	@ Xネ
一 出现	@ X{
一 出	@ X
一 串	@ 
一 撮	@ 技
一 当年	@ 讽~
一 顶风	@ 郴
一 斗争	@ 矮
一 额外	@ B~
一 发明	@ o
一 发现	@ o{
一 发展	@ oi
一 发	@ o
一 奋斗	@ 灸矮
一 丰	@ 伦
一 公布	@ そガ
一 共识	@ @醚
一 共同市场	@ @Pカ初
一 共同	@ @P
一 国家	@ 瓣a
一 技术	@ мN
一 家长	@ a
一 家管	@ a恨
一 家家	@ aa
一 家门	@ a
一 家乡	@ am
一 家小	@ ap
一 家	@ a
一 阶段	@ 顶q
一 决议草案	@ M某螽
一 开发	@ }o
一 课题	@ 揭D
一 疗法	@ 励k
一 疗	@ 励
一 面面	@ 杯
一 签	@ 帽
一 情况	@ 薄p
一 生态学家	@ ネA厩a
一 手术	@ もN
一 殊荣	@ 砗a
一 书法家	@ 血ka
一 特殊	@ S
一 提出	@ 矗X
一 挑战	@ D驹
一 突出	@ 馥X
一 宣布	@ 钮
一 遗迹	@ 框格
一 预测	@ w代
一 专家	@ Ma
一 专门委员会	@ Me|
一 状况	@ p
一 走下	@ ǐU
一 作家	@ @a
依 采	ㄌ 蹦
伊 布	レ ガ
伊 采取	レ 蹦
伊 出口	レ Xf
伊 发动	レ o笆
伊 发生	レ oネ
伊 格	レ 
伊 伦	レ 
伊 万	レ U
衣 裤	 壳
衣 有限公司	 Τそq
仪 提出	祸 矗X
沂 溪	^ 匪
彝 家	U a
椅 倒茶	慈 睡
已 报名	w 厨W
已 并	w }
已 卜	w R
已 采取	w 蹦
已 采用	w 蹦ノ
已 采	w 蹦
已 插秧	w 础
已 查出	w dX
已 超出	w WX
已 超额	w WB
已 撤出	w MX
已 出动	w X笆
已 出口	w Xf
已 出名	w XW
已 出生	w Xネ
已 出世	w X@
已 出土	w Xg
已 出现	w X{
已 出	w X
已 单方面	w 虫よ
已 敦促	w 窗P
已 发表	w o
已 发布	w oガ
已 发出	w oX
已 发电	w oq
已 发放	w o
已 发挥作用	w o揣@ノ
已 发挥	w o揣
已 发掘出	w o备X
已 发生	w oネ
已 发现	w o{
已 发行	w o
已 发展	w oi
已 发	w o
已 公布	w そガ
已 极为	w 伐
已 挤出	w 澜X
已 坚持	w 绊
已 开采	w }蹦
已 刊出	w ZX
已 卖出	w 芥X
已 明显	w 陪
已 拿出	w 偿X
已 排出	w 逼X
已 扑面	w 汲
已 扑	w 汲
已 签署	w 帽p
已 签	w 帽
已 渗出	w 函X
已 提出	w 矗X
已 推出	w 崩X
已 外出	w ~X
已 宣布	w 钮
已 选出	w 匡X
已 意识到	w N醚
已 支出	w やX
已 植树	w 从攫
已 专门	w M
已 自发	w 鄣o
已 走出	w ǐX
已 作出	w @X
乙 甲苯	A ヒf
以 百万	H κU
以 别具一格	H Oㄣ@
以 播放	H 冀
以 采掘	H 蹦备
以 测试	H 代刚
以 城市	H 哎
以 澄清	H 坚M
以 出版社	H X┆
以 出口	H Xf
以 出色	H X
以 出	H X
以 定额	H wB
以 敦促	H 窗P
以 发表	H o
以 发动	H o笆
以 发挥	H o揣
以 发生炉煤气	H oネl费
以 发生	H oネ
以 发行	H o
以 发展	H oi
以 发	H o
以 奋发	H 灸o
以 丰	H 伦
以 扶持	H н
以 扶	H н
以 公布	H そガ
以 共青团	H @C刮
以 共同声明	H @Pn
以 共同	H @P
以 国家	H 瓣a
以 和平共处	H Mキ@B
以 激昂	H E
以 激发	H Eo
以 技术	H мN
以 家庭	H ax
以 坚持	H 绊
以 坚定	H 绊w
以 坚韧不拔	H 绊洞ぃ┺
以 坚实	H 绊龟
以 尖利	H yQ
以 江苏	H 磕
以 局部	H Ы场
以 开发	H }o
以 伦	H 
以 平常	H キ`
以 千万	H dU
以 签署	H 帽p
以 签	H 帽
以 秋	H 
以 驱逐出境	H XvX挂
以 十万	H QU
以 输出	H 块X
以 树立	H 攫ミ
以 苏联	H 默p
以 苏	H 默
以 特殊	H S
以 腾出	H 乃X
以 万	H U
以 违反	H Hは
以 违犯	H Hデ
以 五光十色	H きQ
以 学术	H 厩N
以 严格	H Y
以 艺术	H 美N
以 幽默	H 绽q
以 优异	H u钵
以 有限	H Τ
以 植树	H 从攫
艺 出版社	美 X┆
艺 各有千秋	美 UΤd
艺 家	美 a
抑 止不住	ы ゎぃ
易 驳船	 婚差
易 卜	 R
易 出错	 X岿
易 出问题	 X拜D
易 发	 o
易 复发	 _o
易 开采	 }蹦
易 楼房	 加┬
易 启发	 币o
疫 专家	 Ma
亦 出场	ョ X初
意 采取	N 蹦
意 采用	N 蹦ノ
意 共	N @
意 劳工部长	N 骋u场
意 扑面	N 汲
意 宣布	N 钮
毅 杯	驾 M
义 布	q ガ
义 共和党	q @M囊
义 坚持不懈	q 绊ぃ居
义 翁	q 
益 百万	q κU
益 并	q }
益 出发	q Xo
益 发挥	q o揣
益 发生	q oネ
益 发展	q oi
益 明显	q 陪
议 发生	某 oネ
译 并	亩 }
译 出	亩 X
荫 敬	疆 q
因 采取	] 蹦
因 出版	] X
因 出血	] X
因 出	] X
因 发展	] oi
因 国家	] 瓣a
因 家境	] a挂
因 家庭	] ax
因 家	] a
因 角膜病	] à饯f
因 情况	] 薄p
因 手术	] もN
因 手头	] もY
因 苏联	] 默p
因 违法	] Hk
因 违反	] Hは
因 校舍	] 摘
因 遭受	] D
因 住家	] 懋a
因 自家	] 郛a
音 艺术	 美N
阴 并	潮 }
阴 家庭	潮 ax
银 颁发	蝗 {o
银 发	蝗 o
银 妆	蝗 З
引 堤	ま 出
引 发起	ま o_
印 发给	L o倒
印 共和	L @M
印 共	L @
印 迹	L 格
印 紧张	L 候i
印 美术	L N
印 签	L 帽
英 颁发	^ {o
英 板球	^ Oy
英 采用	^ 蹦ノ
英 出门	^ X
英 出	^ X
英 发明	^ o
英 发现	^ o{
英 发	^ o
英 家	^ a
英 考古学家	^ σj厩a
英 科学家	^ 炀钱a
英 伦	^ 
英 签署	^ 帽p
英 树	^ 攫
英 苏	^ 默
英 专家	^ Ma
婴 出生	捆 Xネ
应 采取	莱 蹦
应 采用	莱 蹦ノ
应 撤出	莱 MX
应 出	莱 X
应 发挥	莱 o揣
应 发生	莱 oネ
应 发展	莱 oi
应 发	莱 o
应 共处	莱 @B
应 共同努力	莱 @PVO
应 共同	莱 @P
应 国家	莱 瓣a
应 汲	莱 V
应 坚持	莱 绊
应 坚决	莱 绊M
应 拿出	莱 偿X
应 能够	莱 喟
应 签	莱 帽
应 苏联	莱 默p
应 苏维埃	莱 默蝴J
应 苏	莱 默
应 宣布	莱 钮
应 严格	莱 Y
应 作出	莱 @X
营 出口商	犁 Xf坝
营 出口	犁 Xf
营 发表	犁 o
营 共	犁 @
营 情况	犁 薄p
营 有限公司	犁 Τそq
迎 出来	 Xㄓ
迎 出门	 X
迎 到家	 飚a
迎 中秋	 い
映 出席	M Xu
映 提出	M 矗X
拥 走出	局 ǐX
庸 指出	e X
踊 现出	裤 {X
涌 出家	F Xa
涌 出	F X
涌 家	F a
涌 文章	F ゅ彻
涌 现出来	F {Xㄓ
涌 现出	F {X
永 发	ッ o
永 格	ッ 
永 万	ッ U
永 战斗	ッ 驹矮
勇 斗	i 矮
勇 舍	i 
勇 伸出	i X
勇 托	i Λ
用 矮	ノ G
用 背包	ノ I]
用 电紧张	ノ q候i
用 发光	ノ o
用 发射机	ノ og诀
用 丰	ノ 伦
用 共同	ノ @P
用 挤出	ノ 澜X
用 技术	ノ мN
用 胶布	ノ 溅ガ
用 客家	ノ 犬a
用 课题	ノ 揭D
用 量杯	ノ qM
用 木板	ノ れO
用 扑克牌	ノ 汲JP
用 人头税	ノ HY|
用 树木	ノ 攫れ
用 树	ノ 攫
用 苏联	ノ 默p
用 万	ノ U
用 艺术	ノ 美N
用 蒸馏水	ノ ]H
用 植树	ノ 从攫
用 自家	ノ 郛a
优 扶持	u н
优 技术	u мN
优 选出	u 匡X
优 种树	u 贺攫
忧 并	~ }
尤 杯	ぷ M
尤 溪	ぷ 匪
由 阿根廷	パ 讧
由 布	パ ガ
由 采矿	パ 蹦q
由 城市	パ 哎
由 出境	パ X挂
由 出口	パ Xf
由 当年	パ 讽~
由 电焊	パ qk
由 发射	パ og
由 发生	パ oネ
由 发展	パ oi
由 丰	パ 伦
由 哥伦比亚	パ 舡郅瘿
由 格	パ 
由 公费医疗	パ そO洛励
由 共青团	パ @C刮
由 国家元首	パ 瓣aじ
由 国家	パ 瓣a
由 技术	パ мN
由 江苏	パ 磕
由 紧张	パ 候i
由 进出口银行	パ iXf蝗
由 开发	パ }o
由 伦敦	パ 鄞
由 洛阳	パ ザ
由 名家	パ Wa
由 评论家	パ 蝶阶a
由 手术	パ もN
由 树木	パ 攫れ
由 苏联	パ 默p
由 苏维埃	パ 默蝴J
由 苏	パ 默
由 特殊	パ S
由 万分	パ Uだ
由 万	パ U
由 亚洲开发银行	パ ㄈw}o蝗
由 中华人民共和国	パ い地Hチ@M瓣
由 主席团	パ Du刮
由 主席	パ Du
由 专家	パ Ma
由 总公司	パ `そq
由 作家	パ @a
油 并	o }
油 出口	o Xf
油 发电	o oq
油 价格	o 基
油 进出口业	o iXf~
油 开采	o }蹦
油 树	o 攫
油 意识	o N醚
游 采购	村 蹦潦
游 城市	村 哎
游 出	村 X
游 发达	村 oF
游 复苏	村 _默
游 价格	村 基
游 批发商	村 уo坝
游 签证	村 帽谍
游 专家	村 Ma
有 阿根廷	Τ 讧
有 白手起家	Τ フも_a
有 百万	Τ κU
有 扁担	Τ 缶
有 布	Τ ガ
有 采用	Τ 蹦ノ
有 采	Τ 蹦
有 成千上万	Τ ΘdWU
有 出兵	Τ XL
有 出口	Τ Xf
有 出路	Τ X隔
有 出乱子	Τ X睹l
有 出色	Τ X
有 出血	Τ X
有 出	Τ X
有 大家	Τ ja
有 当年	Τ 讽~
有 发达	Τ oF
有 发电	Τ oq
有 发烧	Τ oN
有 发生	Τ oネ
有 发言权	Τ oēv
有 发展	Τ oi
有 发	Τ o
有 丰	Τ 伦
有 扶	Τ н
有 哥伦比亚	Τ 舡郅瘿
有 格式	Τ 姒
有 公共	Τ そ@
有 共同	Τ @P
有 共	Τ @
有 雇员	Τ 侗
有 轨迹	Τ y格
有 国家	Τ 瓣a
有 合格	Τ X
有 迹	Τ 格
有 极为	Τ 伐
有 技术	Τ мN
有 坚定	Τ 绊w
有 坚实	Τ 绊龟
有 坚	Τ 绊
有 建树	Τ 鼐
有 江苏	Τ 磕
有 进出口	Τ iXf
有 经济学家	Τ g蕾厩a
有 敬	Τ q
有 局部	Τ Ы场
有 巨额	Τ エB
有 苦恼	Τ Wo
有 疗	Τ 励
有 楼房	Τ 加┬
有 伦	Τ 
有 麻布	Τ 陈ガ
有 明显	Τ 陪
有 木地板	Τ れaO
有 乒乓球	Τ モャy
有 扑灭	Τ 汲防
有 瀑布	Τ rガ
有 启发	Τ 币o
有 千千万万	Τ ddUU
有 千秋	Τ d
有 塞浦路斯	Τ 峨隔吹
有 术	Τ N
有 树木	Τ 攫れ
有 树	Τ 攫
有 苏联	Τ 默p
有 特殊	Τ S
有 体验	Τ 砰喷
有 突出	Τ 馥X
有 驼背	Τ mI
有 万	Τ U
有 违反	Τ Hは
有 校舍	Τ 摘
有 严格	Τ Y
有 艺术家	Τ 美Na
有 幽默	Τ 绽q
有 战斗力	Τ 驹矮O
有 战斗	Τ 驹矮
有 政治条件	Τ Fv兵ン
有 织布机	Τ 麓ガ诀
有 中产阶级	Τ い玻顶
有 专家	Τ Ma
有 专门知识	Τ M久
有 专门	Τ M
右 斗争	k 矮
右 舍	k 
诱 发	护 o
又 矮	S G
又 昂贵	S Q
又 爆发	S zo
又 布	S ガ
又 采取	S 蹦
又 采用	S 蹦ノ
又 查出	S dX
又 出版	S X
又 出发	S Xo
又 出乎	S XG
又 出色	S X
又 出现	S X{
又 出	S X
又 打出	S ゴX
又 发表声明	S o砹n
又 发布	S oガ
又 发动	S o笆
又 发挥	S o揣
又 发生	S oネ
又 发现	S o{
又 发展	S oi
又 发	S o
又 丰	S 伦
又 扶	S н
又 回家	S ^a
又 坚持	S 绊
又 坚实	S 绊龟
又 紧锣密鼓	S 候rK躬
又 敬佩	S qㄘ
又 旧病复发	S 侣f_o
又 开发	S }o
又 流露出	S ySX
又 弥漫	S 辣憨
又 拿出	S 偿X
又 跑出	S ]X
又 喷出	S QX
又 签	S 帽
又 亲笔	S 克掸
又 舍	S 
又 使出	S ㄏX
又 掏出	S 鼻X
又 提出	S 矗X
又 突出	S 馥X
又 推出	S 崩X
又 违背	S HI
又 宣布	S 钮
又 严格	S Y
又 引发	S まo
又 有意识	S ΤN醚
又 找出	S тX
又 指出	S X
又 自发	S 鄣o
又 作出	S @X
幼 发	ギ o
幼 树	ギ 攫
幼 婉	ギ 胞
于 阿根廷	_ 讧
于 矮	_ G
于 昂	_ 
于 巴格达	_ ぺ婀F
于 颁发	_ {o
于 板	_ O
于 报名	_ 厨W
于 爆发	_ zo
于 背	_ I
于 布鲁塞尔	_ ガ|峨焊
于 布	_ ガ
于 采集	_ 蹦栋
于 采取	_ 蹦
于 采用	_ 蹦ノ
于 采	_ 蹦
于 铲	_ 藐
于 城市	_ 哎
于 澄清	_ 坚M
于 出版	_ X
于 出口配额	_ XftB
于 出口	_ Xf
于 出生	_ Xネ
于 出	_ X
于 当年	_ 讽~
于 斗争	_ 矮
于 发布	_ oガ
于 发达	_ oF
于 发电厂	_ oqt
于 发电	_ oq
于 发挥	_ o揣
于 发明	_ o
于 发生	_ oネ
于 发现	_ o{
于 发育	_ o|
于 发展	_ oi
于 发	_ o
于 反共	_ は@
于 防患	_ 颈w
于 丰	_ 伦
于 扶持	_ н
于 扶	_ н
于 拂晓	_ ┴惧
于 高原气候	_ 蔼飚瓠
于 格林	_ 妾L
于 格	_ 
于 攻坚	_ ю绊
于 共产主义	_ @玻Dq
于 共和国	_ @M瓣
于 共同努力	_ @PVO
于 共同	_ @P
于 国家	_ 瓣a
于 激发	_ Eo
于 技术员	_ мN
于 技术	_ мN
于 家庭	_ ax
于 家	_ a
于 价格	_ 基
于 坚持不懈	_ 绊ぃ居
于 坚持	_ 绊
于 坚定不移	_ 绊wぃ簿
于 坚决	_ 绊M
于 坚挺	_ 绊
于 江苏	_ 磕
于 紧张	_ 候i
于 进出口业	_ iXf~
于 进出口	_ iXf
于 经济复苏	_ g蕾_默
于 喀布尔	_ 池ガ焊
于 开采	_ }蹦
于 开发	_ }o
于 客家	_ 犬a
于 浪漫	_ 龊
于 伦敦	_ 鄞
于 洛阳	_ ザ
于 美术	_ N
于 密布	_ Kガ
于 女王	_ k
于 皮层	_ ブh
于 乒乓	_ モャ
于 扑灭	_ 汲防
于 扑	_ 汲
于 签署	_ 帽p
于 签	_ 帽
于 树木	_ 攫れ
于 树	_ 攫
于 水土流失	_ 簸gyア
于 苏联	_ 默p
于 苏醒	_ 默眶
于 苏	_ 默
于 提出	_ 矗X
于 外出	_ ~X
于 外来	_ ~ㄓ
于 挽救	_ 颈
于 违反	_ Hは
于 西藏	_ 杪
于 校舍	_ 摘
于 悬殊	_ a
于 严格	_ Y
于 研究出	_ 悒sX
于 秧苗	_ 杯]
于 艺术院	_ 美N|
于 意识	_ N醚
于 英格兰	_ ^婺
于 预测	_ w代
于 遭受	_ D
于 找出	_ тX
于 植树	_ 从攫
于 治疗	_ v励
于 中华人民共和国	_ い地Hチ@M瓣
于 专门	_ M
于 资格	_ 戈
愚 出	M X
余 并	E }
余 额	E B
余 画家	E ea
余 家	E a
余 坚持	E 绊
余 解释	E 秆睦
余 扑	E 汲
余 秋	E 
余 万人	E UH
余 万	E U
余 演出	E tX
逾 百万吨	O κU痉
逾 百万	O κU
逾 十万	O QU
鱼 共	辰 @
鱼 提出抗议	辰 矗Xк某
渝 茶楼	袋 加
渔 出席	寒 Xu
渔 况	寒 p
予 出口	ぉ Xf
予 格外	ぉ 妤~
予 公布	ぉ そガ
予 宣布	ぉ 钮
雨 痕迹	B 勃格
与 阿根廷	P 讧
与 百万	P κU
与 布宜诺斯艾利斯	P ガy空吹悃Q吹
与 布	P ガ
与 城市	P 哎
与 出版	P X
与 出口	P Xf
与 出路	P X隔
与 出席	P Xu
与 大家	P ja
与 斗	P 矮
与 发达	P oF
与 发动机	P o笆诀
与 发动	P o笆
与 发放	P o
与 发挥	P o揣
与 发酵	P o幻
与 发掘	P o备
与 发展	P oi
与 发	P o
与 反共	P は@
与 哥伦比亚	P 舡郅瘿
与 共产党	P @玻囊
与 共和党	P @M囊
与 共和国	P @M瓣
与 共和	P @M
与 共同	P @P
与 共	P @
与 国家	P 瓣a
与 皇家	P 赢a
与 技术	P мN
与 家人	P aH
与 家庭	P ax
与 价格	P 基
与 坚持	P 绊
与 坚信	P 绊H
与 进出口	P iXf
与 开发	P }o
与 科学家	P 炀钱a
与 派出所	P ％X┮
与 品格	P ~
与 融洽	P 磕
与 树立	P 攫ミ
与 树脂	P 攫
与 苏联	P 默p
与 苏	P 默
与 挑战	P D驹
与 万	P U
与 违法	P Hk
与 未婚夫	P ゼBひ
与 西藏	P 杪
与 先进国家	P i瓣a
与 现阶段	P {顶q
与 严格	P Y
与 医疗	P 洛励
与 艺术	P 美N
与 英格兰	P ^婺
与 战斗	P 驹矮
与 争斗	P О
与 政治条件	P Fv兵ン
与 中华人民共和国	P い地Hチ@M瓣
与 专家	P Ma
与 总公司	P `そq
与 尊敬	P Lq
屿 疗养院	垃 励i|
禹 杯	 M
禹 出面	 X
玉 雕塑	ド J鹅
玉 雕	ド J
玉 家	ド a
玉 全家	ド a
玉 树	ド 攫
玉 溪	ド 匪
域 出土	办 Xg
域 发生	办 oネ
域 共	办 @
域 之外	办 ぇ~
郁 乡土气息	 mg甬
吁 布	S ガ
吁 采取	S 蹦
吁 发达	S oF
吁 塞浦路斯	S 峨隔吹
吁 苏联	S 默p
吁 知情	S 颈
遇 并	J }
遇 迹	J 格
遇 特殊	J S
喻 万	畴 U
御 并	s }
御 技术	s мN
御 外来	s ~ㄓ
愈 出	U X
愈 发	U o
愈 坚	U 绊
欲 熏	饼 饫
育 出来	| Xㄓ
育 出	| X
育 手术	| もN
育 树苗	| 攫]
豫 出席	枯 Xu
元 出差	じ Xt
元 发生	じ oネ
元 国家	じ 瓣a
元 回家	じ ^a
元 家	じ a
元 推出	じ 崩X
垣 有限公司	 Τそq
袁 婉	K 胞
原 板	 O
原 材料价格	 鳟苹
原 发	 o
原 江苏	 磕
原 西藏	 杪
原 装甲兵	 杆ヒL
园 杯	堕 M
园 采访	堕 蹦X
园 采矿	堕 蹦q
园 发展	堕 oi
员 报名	 厨W
员 并	 }
员 布	 ガ
员 出	 X
员 顶风	 郴
员 斗	 矮
员 发生	 oネ
员 发现	 o{
员 发	 o
员 扶	 н
员 付出	 IX
员 共	 @
员 家属	 a妮
员 家庭	 ax
员 坚持不懈	 绊ぃ居
员 坚持	 绊
员 敬	 q
员 救出	 毕X
员 签名	 帽W
员 签署	 帽p
员 签章	 帽彻
员 提出	 矗X
员 外出	 ~X
员 文章	 ゅ彻
员 严格	 Y
员 演出	 tX
员 医疗费用	 洛励Oノ
员 指出	 X
员 资格	 戈
源 出席	方 Xu
源 发出	方 oX
源 丰	方 伦
源 后发制人	方 岬o瞍H
源 明显	方 陪
源 情况	方 薄p
缘 出现	t X{
远 杯	环 M
远 指出	环 X
远 总公司	环 `そq
远 诙谐	环 纲坑
苑 出版社	b X┆
愿 报名	@ 厨W
愿 出	@ X
愿 大家	@ ja
愿 发展	@ oi
愿 拿出	@ 偿X
愿 签名	@ 帽W
愿 苏联	@ 默p
院 发表	| o
院 发布	| oガ
院 发挥	| o揣
院 分庭抗礼	| だxк搂
院 公报	| そ厨
院 共同	| @P
院 共	| @
院 果树	| G攫
院 技术人员	| мNH
院 家禽	| aV
院 坚持	| 绊
院 民族学	| チ壁厩
院 签	| 帽
院 树木	| 攫れ
院 选出	| 匡X
院 研究出	| 悒sX
院 演出	| tX
院 治疗	| v励
院 主席团	| Du刮
院 主席	| Du
约 发言人	 oēH
约 发展	 oi
约 国家	 瓣a
约 伦敦	 鄞
约 苏联	 默p
约 提出	 矗X
约 万	 U
约 作出	 @X
越 背	V I
越 采访	V 蹦X
越 斗争	V 矮
越 丰	V 伦
越 共	V @
越 坚	V 绊
越 签	V 帽
跃 出	D X
岳 出席	┄ Xu
岳 果树	┄ G攫
岳 家	┄ a
月 爆发	る zo
月 采取	る 蹦
月 超额	る WB
月 出版	る X
月 出口	る Xf
月 出生	る Xネ
月 出席	る Xu
月 出现	る X{
月 发表	る o
月 发动	る o笆
月 发射	る og
月 发生	る oネ
月 发现	る o{
月 发行	る o
月 发	る o
月 公布	る そガ
月 共同	る @P
月 坚持	る 绊
月 排出	る 逼X
月 签署	る 帽p
月 签	る 帽
月 情况	る 薄p
月 苏	る 默
月 提出	る 矗X
月 推出	る 崩X
月 退出	る hX
月 宣布	る 钮
月 选出	る 匡X
月 专门	る M
月 作出	る @X
悦 逼	 G
云 出	冻 X
云 发表	冻 o
云 坚定	冻 绊w
云 密布	冻 Kガ
云 提出	冻 矗X
云 溪	冻 匪
云 指出	冻 X
运 城市	B 哎
运 出境	B X挂
运 出来	B Xㄓ
运 出去	B Xh
运 出	B X
运 发往	B o┕
运 丰	B 伦
运 农家	B Aa
运 情况	B 薄p
运 指出	B X
运 总公司	B `そq
杂 树	馒 攫
栽 果树	 G攫
栽 技术	 мN
栽 秋	 
栽 树林	 攫L
栽 树苗	 攫]
栽 树	 攫
哉 竖起	v 捷_
灾 倒塌	a 硕
灾 斗争	a 矮
灾 发生	a oネ
灾 极为	a 伐
灾 技术	a мN
灾 情况	a 薄p
灾 意识	a N醚
再 采取	A 蹦
再 出现	A X{
再 单方面	A 虫よ
再 发动	A o笆
再 发放	A o
再 发生	A oネ
再 发现	A o{
再 发展	A oi
再 回家	A ^a
再 开发	A }o
再 拿出	A 偿X
再 签	A 帽
再 生出	A ネX
再 提出	A 矗X
再 作出	A @X
在 阿根廷	b 讧
在 阿姆斯特丹	b i吹Sう
在 爱尔兰共和国	b R焊孽@M瓣
在 昂	b 
在 巴格达	b ぺ婀F
在 百万	b κU
在 颁发	b {o
在 板门店	b O┍
在 板	b O
在 报名处	b 厨WB
在 报名	b 厨W
在 爆发	b zo
在 背道而驰	b IDτ梗
在 搏斗	b i矮
在 布达佩斯	b ガFㄘ吹
在 布袋	b ガU
在 布加勒斯特	b ガ[扒吹S
在 布拉格	b ガ┰
在 布鲁塞尔	b ガ|峨焊
在 布置	b ガm
在 布	b ガ
在 采访	b 蹦X
在 采集	b 蹦栋
在 采取	b 蹦
在 采用	b 蹦ノ
在 采	b 蹦
在 草案	b 螽
在 城市	b 哎
在 出版	b X
在 出口贸易	b XfT
在 出口	b Xf
在 出入	b XJ
在 出生	b Xネ
在 出事	b Xㄆ
在 出售	b X扳
在 出席	b Xu
在 出	b X
在 春秋	b K
在 大家	b ja
在 当年	b 讽~
在 堤	b 出
在 电子显微镜	b ql陪L描
在 斗争	b 矮
在 发表	b o
在 发布	b oガ
在 发达	b oF
在 发放	b o
在 发给	b o倒
在 发挥	b o揣
在 发射	b og
在 发生	b oネ
在 发现	b o{
在 发行	b o
在 发芽	b o
在 发扬光大	b o喘j
在 发音	b o
在 发展	b oi
在 发	b o
在 返家	b 甬a
在 奋斗	b 灸矮
在 丰	b 伦
在 扶	b н
在 高原气候	b 蔼飚瓠
在 哥伦比亚	b 舡郅瘿
在 格林	b 妾L
在 格	b 
在 公报	b そ厨
在 公布	b そガ
在 公共汽车	b そ@Tó
在 共产党员	b @玻囊
在 共产党	b @玻囊
在 共产	b @玻
在 共和国	b @M瓣
在 共和	b @M
在 共青团	b @C刮
在 共同生活	b @Pネ
在 共同	b @P
在 共有	b @Τ
在 共	b @
在 国家预算	b 瓣aw衡
在 国家	b 瓣a
在 果树	b G攫
在 焊	b k
在 和平共处	b Mキ@B
在 合家	b Xa
在 黑板	b 堵O
在 葫芦	b 脯莫
在 回家	b ^a
在 婚姻	b B
在 激昂	b E
在 鸡舍	b 蔓
在 极为	b 伐
在 汲	b V
在 技术	b мN
在 家常	b a`
在 家长	b a
在 家家户户	b aaめめ
在 家门	b a
在 家事	b aㄆ
在 家庭	b ax
在 家乡	b am
在 家用	b aノ
在 家	b a
在 价格	b 基
在 坚持	b 绊
在 坚定	b 绊w
在 江苏	b 磕
在 阶级斗争	b 顶虐
在 解释	b 秆睦
在 紧张	b 候i
在 经济复苏	b g蕾_默
在 颈	b V
在 敬	b q
在 局部麻醉	b Ы场陈K
在 局部	b Ы场
在 喀布尔	b 池ガ焊
在 开采	b }蹦
在 开发	b }o
在 课堂	b 揭绑
在 课题	b 揭D
在 喇嘛	b 斥估
在 老家	b ρa
在 联合公报	b pXそ厨
在 列宁格勒	b C圭姘
在 卢布	b cガ
在 伦敦	b 鄞
在 罗布泊	b 霉ガy
在 罗布	b 霉ガ
在 洛阳	b ザ
在 漫	b 憨
在 美术馆	b N]
在 默默	b qq
在 母校	b ダ
在 纽伦堡	b 铆鄢
在 农家	b Aa
在 拍照	b ╃酚
在 婆家	b Ca
在 扑灭	b 汲防
在 扑朔迷离	b 汲野g瞒
在 千秋	b d
在 千万	b dU
在 签署	b 帽p
在 签字	b 帽r
在 签	b 帽
在 秋风	b 瞽
在 秋季	b 瞟u
在 秋天	b 瞍
在 任职期	b ヴ戮戳
在 肉类	b ψ摸
在 塞浦路斯	b 峨隔吹
在 石油输出国组织	b ホo块X瓣舱麓
在 手术台	b もNx
在 手术	b もN
在 树干	b 攫F
在 树木	b 攫れ
在 树叶	b 攫腑
在 树	b 攫
在 水力发电	b 簸Ooq
在 水土保持	b 簸gO
在 苏丹	b 默う
在 苏格兰	b 默婺
在 苏黎世	b 默兢@
在 苏联	b 默p
在 苏州	b 默{
在 苏	b 默
在 塌方	b 厄よ
在 塌陷	b 厄炒
在 汤杯	b 傣M
在 特殊	b S
在 提出	b 矗X
在 突出	b 馥X
在 托	b Λ
在 外出	b ~X
在 万里长空	b U姜
在 万人	b UH
在 万象更新	b UH蠓s
在 万象	b UH
在 万	b U
在 文章	b ゅ彻
在 西藏	b 杪
在 溪	b 匪
在 现阶段	b {顶q
在 新婚	b sB
在 新闻公报	b sDそ厨
在 新英格兰	b s^婺
在 邢	b ǚ
在 宣布	b 钮
在 学术交流	b 厩Nユy
在 学术界	b 厩N
在 学术	b 厩N
在 严格	b Y
在 一连串	b @s
在 医疗	b 洛励
在 艺术节	b 美N`
在 艺术	b 美N
在 亿万	b 货U
在 意识	b N醚
在 英格兰	b ^婺
在 有限	b Τ
在 遭受	b D
在 战场	b 驹初
在 战斗部队	b 驹矮场钉
在 战斗	b 驹矮
在 针布	b wガ
在 支出	b やX
在 直布罗陀	b 渐霉
在 植树	b 从攫
在 治疗中	b v励い
在 治疗	b v励
在 中华人民共和国	b い地Hチ@M瓣
在 中线	b いu
在 主席台	b Dux
在 专家	b Ma
在 专门	b M
在 追悼会	b l饱|
在 自家	b 郛a
在 总公司	b `そq
在 总共	b `@
在 作出	b @X
在 侃侃而谈	b ㄔㄔτ酵
咱 国家	 瓣a
咱 提出	 矗X
赞 布	g ガ
葬 出土	府 Xg
遭 潜水艇	D 肩舾
遭 秋	D 
遭 英格兰	D ^婺
凿 出	w X
早 插秧	Ν 础
早 出现	Ν X{
早 发现	Ν o{
早 阶段	Ν 顶q
早 开发	Ν }o
早 拿出	Ν 偿X
早 扑	Ν 汲
早 作出	Ν @X
造 布	y ガ
造 城市	y 哎
造 出来	y Xㄓ
造 出	y X
造 技术	y мN
造 术	y N
造 完毕	y Ч拨
造 有限公司	y Τそq
灶 采光	_ 蹦
则 采取	h 蹦
则 出现	h X{
则 发挥	h o揣
则 坚持	h 绊
则 明显	h 陪
则 跑出	h ]X
则 提出	h 矗X
则 宣布	h 钮
则 一下子	h @Ul
则 战场	h 驹初
则 指出	h X
泽 老家	A ρa
增 额	W B
增 发电	W oq
增 发	W o
增 公共	W そ@
增 佩	W ㄘ
增 树木	W 攫れ
曾 白手起家	纯 フも_a
曾 采用	纯 蹦ノ
曾 出版	纯 X
曾 出席	纯 Xu
曾 出现	纯 X{
曾 出	纯 X
曾 单方面	纯 虫よ
曾 发生	纯 oネ
曾 发现	纯 o{
曾 发行	纯 o
曾 发展	纯 oi
曾 扶持	纯 н
曾 敬	纯 q
曾 刊出	纯 ZX
曾 佩	纯 ㄘ
曾 提出	纯 矗X
曾 写文章	纯 gゅ彻
曾 宣布	纯 钮
曾 预测	纯 w代
曾 遭受	纯 D
曾 指出	纯 X
曾 作出	纯 @X
扎 布	蚕 ガ
扎 出来	蚕 Xㄓ
扎 出席	蚕 Xu
渣 技术	错 мN
轧 板	 O
轧 薄板	 痢O
轧 出	 X
闸 底板	h ┏O
咋 揭发	Q 处o
炸 塌	 厄
摘 出	K X
寨 采访	闺 蹦X
寨 出来	闺 Xㄓ
寨 树	闺 攫
詹 坚持	糕 绊
粘 布鞋	诌 ガc
展 并	i }
展 出场	i X初
展 出	i X
展 斗争	i 矮
展 丰	i 伦
展 扶	i н
展 共	i @
展 国家	i 瓣a
展 果树	i G攫
展 画家	i ea
展 技术	i мN
展 家庭	i ax
展 进出口贸易	i iXfT
展 情况	i 薄p
展 手术	i もN
展 违法	i Hk
展 现出来	i {Xㄓ
展 现出	i {X
展 学术交流	i 厩Nユy
展 学术	i 厩N
展 医疗	i 洛励
展 植树	i 从攫
占 城市	 哎
占 出口	 Xf
占 当年	 讽~
占 定额	 wB
占 发放	 o
占 发生	 oネ
占 发展	 oi
占 公家	 そa
占 国家预算	 瓣aw衡
占 国家	 瓣a
占 家庭	 ax
占 开发	 }o
占 贸易额	 T雒B
占 佩	 ㄘ
占 全家	 a
占 肉类	 ψ摸
占 苏	 默
占 无家可归	 Laik
占 西藏	 杪
占 校舍	 摘
战 斗争	驹 矮
战 苏联	驹 默p
战 挑战	驹 D驹
站 并	 }
站 播放	 冀
站 布	 ガ
站 采取	 蹦
站 出场	 X初
站 出来	 Xㄓ
站 发现	 o{
站 发	 o
站 共同	 @P
站 共	 @
站 坚持	 绊
站 星罗棋布	 P霉囱ガ
站 演出	 tX
站 总工程师	 `u{v
绽 出	红 X
章 敬	彻 q
章 指出	彻 X
张 并	i }
张 采	i 蹦
张 澄	i 坚
张 斗	i 矮
张 发	i o
张 丰	i 伦
张 共同	i @P
张 家庭	i ax
张 家	i a
张 敬	i q
张 面额	i 泵B
张 秋	i 
张 树根	i 攫
张 树	i 攫
张 特殊	i S
张 万年	i U~
张 万	i U
张 性格	i ┦
胀 背景	等 I春
找 婆家	т Ca
找 行家	т 娈a
赵 发	化 o
赵 家	化 a
赵 树	化 攫
赵 婉	化 胞
照 发展	酚 oi
照 国家	酚 瓣a
照 葫芦	酚 脯莫
兆 坚	 绊
折 出头	ч XY
哲 共	 @
者 颁发	 {o
者 杯	 M
者 并	 }
者 出现	 X{
者 发布	 oガ
者 发生	 oネ
者 发	 o
者 腹部	 浮场
者 滚出	 uX
者 家门	 a
者 家属	 a妮
者 坚持	 绊
者 敬	 q
者 明显	 陪
者 默	 q
者 签名	 帽W
者 签	 帽
者 施行手术	 I妞獬N
者 术	 N
者 素昧平生	 垃Nキネ
者 提出	 矗X
者 义演	 qt
者 有希望	 Τ票
者 指出	 X
者 治疗	 v励
这 背	o I
这 并	o }
这 出	o X
这 当年	o 讽~
这 斗争	o 矮
这 丰	o 伦
这 火树银花	o 蹙鸹泉
这 家小	o ap
这 家	o a
这 阶段	o 顶q
这 情况	o 薄p
这 特殊	o S
这 万分	o Uだ
这 形态	o 魏A
这 一家人	o @aH
珍 家	 a
珍 马术	 皑N
真 并	u }
真 格	u 
真 好比	u nゑ
真 树	u 攫
针 并	w }
针 发展	w oi
针 织布	w 麓ガ
针 治疗	w v励
针 作出	w @X
诊 共	E @
诊 情况	E 薄p
震 技术	_ мN
震 塌	_ 厄
震 专门	_ M
振 丰	 伦
振 殊	 
镇 出	马 X
镇 发现	马 o{
镇 敬	马 q
镇 酒家	马 sa
镇 派出所	马 ％X┮
镇 体验	马 砰喷
镇 万	马 U
镇 溪	马 匪
镇 已开发	马 w}o
镇 艺术	马 美N
镇 桦树	马 眷攫
阵 现阶段	} {顶q
蒸 出	] X
征 报名	┖ 厨W
征 出口	┖ Xf
征 丰	┖ 伦
征 共产主义	┖ @玻Dq
征 国家	┖ 瓣a
征 文章	┖ ゅ彻
争 百万富翁	 κUI
争 出外	 X~
争 出	 X
争 国家	 瓣a
整 妆	俱 З
正 布置	タ ガm
正 采取	タ 蹦
正 出现	タ X{
正 发表	タ o
正 发愁	タ oT
正 发挥	タ o揣
正 发	タ o
正 焕发	タ 坟o
正 紧锣密鼓	タ 候rK躬
正 紧张	タ 候i
正 树	タ 攫
正 严格	タ Y
政 出	F X
政 共	F @
政 家	F a
政 情况	F 薄p
政 意识	F N醚
帧 艺术	V 美N
症 明显	g 陪
郑 家	G a
郑 万	G U
证 颁发	谍 {o
证 采	谍 蹦
证 婚	谍 B
证 阶段	谍 顶q
证 开采	谍 }蹦
证 西藏	谍 杪
枝 技术	K мN
枝 腊梅	K 镁宾
支 共同	や @P
支 国家	や 瓣a
支 坚持	や 绊
支 特殊	や S
支 医疗	や 洛励
支 战场	や 驹初
支 专门	や M
吱 格	s 
知 出	 X
知 家乡	 am
知 外来	 ~ㄓ
知 万	 U
知 植树	 从攫
脂 布	 ガ
之 并	ぇ }
之 发生	ぇ oネ
之 发扬光大	ぇ o喘j
之 发展	ぇ oi
之 发	ぇ o
之 奋斗	ぇ 灸矮
之 丰	ぇ 伦
之 共同努力	ぇ @PVO
之 痕迹	ぇ 勃格
之 家	ぇ a
之 坚持	ぇ 绊
之 列席	ぇ Cu
之 秋	ぇ 
之 趋向	ぇ 镣V
之 树	ぇ 攫
之 托	ぇ Λ
织 出	麓 X
职 并	戮 }
职 技术	戮 мN
直 逼	 G
直 扑	 汲
直 树	 攫
植 发	从 o
植 果树	从 G攫
值 当年	 讽~
值 共	 @
址 出土	} Xg
址 发现	} o{
指 国家	 瓣a
指 手术	 もN
只 出生	u Xネ
只 发生	u oネ
只 发现	u o{
只 发展	u oi
只 发	u o
只 家禽	u aV
只 喇叭	u 斥z
只 提出	u 矗X
只 跳出	u 铬X
只 推出	u 崩X
纸 雕	 J
纸 术	 N
志 澄	в 坚
志 出版	в X
志 出席	в Xu
志 发表	в o
志 发	в o
志 公布	в そガ
志 共	в @
志 坚	в 绊
志 伦	в 
志 派出所	в ％X┮
志 指出	в X
至 阿根廷	 讧
至 铲	 藐
至 出国	 X瓣
至 出口	 Xf
至 当年	 讽~
至 发稿	 oZ
至 发生	 oネ
至 发展	 oi
至 格	 
至 乒乓球	 モャy
至 全家	 a
至 十万	 QU
至 苏联	 默p
至 小溪	 p匪
致 出现	P X{
致 发光	P o
致 发生	P oネ
致 哥伦比亚	P 舡郅瘿
致 苏联	P 默p
置 国家	m 瓣a
置 扑	m 汲
置 西藏	m 杪
置 医疗	m 洛励
制 板	 O
制 并	 }
制 出超	 XW
制 出来	 Xㄓ
制 出生	 Xネ
制 出	 X
制 发挥	 o揣
制 发生	 oネ
制 发展	 oi
制 发	 o
制 共	 @
制 国家	 瓣a
制 技术	 мN
制 开发	 }o
制 帽	 U
制 平板	 キO
制 签章	 帽彻
制 情况	 薄p
制 提出	 矗X
制 西藏	 杪
制 止不住	 ゎぃ
制 走出	 ǐX
智 出席	醇 Xu
智 家	醇 a
质 薄板	借 痢O
质 治疗	借 v励
治 杯	v M
治 技术	v мN
治 手术	v もN
治 违法	v Hk
治 意识	v N醚
治 指出	v X
中 板	い O
中 薄板	い 痢O
中 并	い }
中 采访	い 蹦X
中 采取	い 蹦
中 采用	い 蹦ノ
中 城市	い 哎
中 抽出	い ┾X
中 出动	い X笆
中 出口	い Xf
中 出色	い X
中 出生入死	い XネJ
中 出生	い Xネ
中 出土	い Xg
中 出现	い X{
中 出	い X
中 串	い 
中 打出	い ゴX
中 待售	い 莅
中 当年	い 讽~
中 敦促	い 窗P
中 发表	い o
中 发出	い oX
中 发电	い oq
中 发挥作用	い o揣@ノ
中 发挥	い o揣
中 发起	い o_
中 发生	い oネ
中 发誓	い o}
中 发现	い o{
中 发扬光大	い o喘j
中 发展	い oi
中 发	い o
中 复苏	い _默
中 腹背受敌	い 浮I寄
中 格调	い 娼
中 公布	い そガ
中 共处	い @B
中 共党	い @囊
中 共和	い @M
中 共同	い @P
中 共有	い @Τ
中 共	い @
中 国家	い 瓣a
中 极为	い 伐
中 汲	い V
中 挤出	い 澜X
中 技术	い мN
中 坚持	い 绊
中 建树	い 鼐
中 江苏	い 磕
中 借出	い 丧X
中 救出	い 毕X
中 居先	い ~
中 看出	い 荪X
中 科学家	い 炀钱a
中 漫	い 憨
中 明显	い 陪
中 默默	い qq
中 拿出	い 偿X
中 能够	い 喟
中 喷出	い QX
中 扑	い 汲
中 情况	い 薄p
中 全家	い a
中 树立	い 攫ミ
中 竖起	い 捷_
中 苏联	い 默p
中 苏	い 默
中 掏出	い 鼻X
中 提出	い 矗X
中 投出	い щX
中 突出	い 馥X
中 涂油	い 额o
中 推出	い 崩X
中 脱颖而出	い 叉oτX
中 西藏	い 杪
中 西医	い 杪
中 宣布	い 钮
中 严格	い Y
中 演出	い tX
中 意识到	い N醚
中 溢出	い 犯X
中 引发	い まo
中 遭受	い D
中 找出	い тX
中 正式宣布	い タΑ钮
中 知悉	い 颈x
中 指出	い X
中 专门	い M
中 走出	い ǐX
中 作出	い @X
忠 出席	┚ Xu
忠 家	┚ a
忠 漫画	┚ 憨e
忠 提出	┚ 矗X
钟 发	牧 o
钟 家	牧 a
钟 敬	牧 q
钟 佩	牧 ㄘ
钟 万	牧 U
钟 指出	牧 X
种 昂	贺 
种 板栗	贺 O
种 爆发	贺 zo
种 背景	贺 I春
种 表格	贺 懋
种 出口商	贺 Xf坝
种 出口	贺 Xf
种 出现	贺 X{
种 出	贺 X
种 单方面	贺 虫よ
种 定名	贺 wW
种 发愁	贺 oT
种 发射	贺 og
种 发展	贺 oi
种 丰	贺 伦
种 格局	贺 妲
种 共同	贺 @P
种 共	贺 @
种 规格	贺 W
种 国家	贺 瓣a
种 果树	贺 G攫
种 化妆品	贺 てЗ~
种 迹	贺 格
种 技术	贺 мN
种 家庭	贺 ax
种 价格	贺 基
种 坚韧不拔	贺 绊洞ぃ┺
种 江苏	贺 磕
种 叫嚣	贺 s嫩
种 阶段	贺 顶q
种 疗法	贺 励k
种 面额	贺 泵B
种 明显	贺 陪
种 能够	贺 喟
种 扑灭	贺 汲防
种 前列腺	贺 eC涪
种 潜能	贺 肩
种 情况	贺 薄p
种 手术	贺 もN
种 树苗	贺 攫]
种 树木	贺 攫れ
种 思潮	贺 浼
种 特殊	贺 S
种 挑战	贺 D驹
种 违背	贺 HI
种 医术	贺 洛N
种 移植	贺 簿从
种 艺术	贺 美N
种 意识	贺 N醚
种 战斗	贺 驹矮
种 战术	贺 驹N
种 治疗	贺 v励
种 专家	贺 Ma
种 专门	贺 M
种 状况	贺 p
重 梳妆	 蕨
重 提出	 矗X
重 托	 Λ
重 指出	 X
仲 发	ヲ o
周 出席	P Xu
周 出现	P X{
周 出	P X
周 家	P a
周 拿出	P 偿X
周 宣布	P 钮
州 爆发	{ zo
州 发生	{ oネ
州 发现	{ o{
州 发展	{ oi
州 发	{ o
州 共和	{ @M
州 共同	{ @P
州 共有	{ @Τ
州 技术	{ мN
州 敬	{ q
州 劳工部长	{ 骋u场
州 万人	{ UH
洲 国家	w 瓣a
珠 家	] a
珠 如数家珍	] p计a
珠 专门	] M
株 桂树	 劬
株 梅树	 宾攫
株 树木	 攫れ
株 树	 攫
株 槟榔树	 b}攫
朱 昂	Χ 
朱 布	Χ ガ
朱 家	Χ a
朱 敬	Χ q
朱 佩	Χ ㄘ
猪 杯	睫 M
猪 出	睫 X
猪 喘气	睫 齿
猪 技术	睫 мN
猪 价格	睫 基
诸 城市	窖 哎
逐 家	v a
嘱 托	篷 Λ
主 仆	D 共
主 苏联	D 默p
主 提出	D 矗X
主 意识	D N醚
主 战场	D 驹初
著 矮小	帝 Gp
著 百万	帝 κU
著 板车	帝 Oó
著 采购	帝 蹦潦
著 茶杯	帝 M
著 超出	帝 WX
著 成串	帝 Θ
著 崇敬	帝 Rq
著 出版	帝 X
著 出现	帝 X{
著 出主意	帝 XDN
著 出	帝 X
著 大家	帝 ja
著 电话铃	帝 q杠a
著 斗	帝 矮
著 发展	帝 oi
著 发	帝 o
著 分娩	帝 だY
著 丰	帝 伦
著 格外	帝 妤~
著 共产主义	帝 @玻Dq
著 共同	帝 @P
著 国家	帝 瓣a
著 极为	帝 伐
著 技术	帝 мN
著 家庭生活	帝 axネ
著 家	帝 a
著 甲苯	帝 ヒf
著 坚持	帝 绊
著 坚定不移	帝 绊wぃ簿
著 坚定	帝 绊w
著 坚实	帝 绊龟
著 解释	帝 秆睦
著 紧张	帝 候i
著 开发	帝 }o
著 螺帽	帝 脸U
著 漫	帝 憨
著 明显	帝 陪
著 拿出	帝 偿X
著 扑克牌	帝 汲JP
著 千变万化	帝 d跑Uて
著 钦佩	帝 窜ㄘ
著 术	帝 N
著 树	帝 攫
著 苏	帝 默
著 塑胶地板	帝 鹅溅aO
著 特殊	帝 S
著 挑战	帝 D驹
著 拖地板	帝 ╈aO
著 挽救	帝 颈
著 万	帝 U
著 五颜六色	帝 きCせ
著 西藏	帝 杪
著 宣布	帝 钮
著 血迹	帝 甯
著 亿万	帝 货U
著 指出	帝 X
著 中华人民共和国	帝 い地Hチ@M瓣
著 走出	帝 ǐX
著 橄榄树	帝 抉V攫
助 签字	U 帽r
铸 板	疟 O
铸 技术	疟 мN
筑 出	诞 X
筑 堤	诞 出
筑 风格	诞 樊
筑 海堤	诞 出
筑 技术	诞 мN
筑 家	诞 a
筑 坚固	诞 绊T
筑 美术	诞 N
筑 涂料	诞 额
筑 艺术	诞 美N
筑 专家	诞 Ma
筑 总公司	诞 `そq
住 出来	 Xㄓ
住 夺眶而出	 管驳τX
住 价格	 基
住 流下	 yU
祝 大家	 ja
驻 阿根廷	n 讧
驻 巴格达	n ぺ婀F
驻 布鲁塞尔	n ガ|峨焊
驻 布	n ガ
驻 城市	n 哎
驻 哥伦比亚	n 舡郅瘿
驻 列宁格勒	n C圭姘
驻 塞浦路斯	n 峨隔吹
驻 苏丹	n 默う
驻 苏联	n 默p
驻 苏	n 默
驻 西藏	n 杪
驻 中非共和国	n いD@M瓣
抓 城市	ъ 哎
抓 出口	ъ Xf
抓 出	ъ X
抓 共	ъ @
抓 技术	ъ мN
抓 扑	ъ 汲
抓 西藏	ъ 杪
抓 植树	ъ 从攫
拽 出	 X
专 发	M o
转 城市	锣 哎
转 出生	锣 Xネ
转 国家	锣 瓣a
赚 公家	寥 そa
庄 采访	缠 蹦X
庄 串联	缠 炅p
庄 串	缠 
庄 签署	缠 帽p
装 出口贸易	杆 XfT
装 出口	杆 Xf
装 发展	杆 oi
装 回家	杆 ^a
装 技术	杆 мN
装 贸易额	杆 T雒B
装 走出	杆 ǐX
妆 的	З 
妆 点	З I
妆 素	З 
妆 玉	З ド
准 采访	 蹦X
准 采用	 蹦ノ
准 格	 
准 焊	 k
准 合格	 X
准 明显	 陪
准 情况	 薄p
准 提出	 矗X
准 严格	 Y
桌 敬酒	 qs
桌 支出	 やX
兹 布	 ガ
资 并	戈 }
资 额	戈 B
资 价格	戈 基
姿 焕发	 坟o
仔 仔细	J J灿
籽 出口	 Xf
籽 能够	 喟
子 昂	l 
子 板	l O
子 并	l }
子 布	l ガ
子 抽出	l ┾X
子 出现	l X{
子 发现	l o{
子 阶段	l 顶q
子 恼	l o
子 走下	l ǐU
自 并	 }
自 发布	 oガ
自 发明	 o
自 国家	 瓣a
自 技术	 мN
自 漫画	 憨e
自 树	 攫
自 苏联	 默p
自 提出	 矗X
自 违反	 Hは
自 西藏	 杪
字 签名	r 帽W
字 做文章	r 暗ゅ彻
宗 出口	v Xf
宗 提出	v 矗X
综 采	侯 蹦
总 爆发	` zo
总 出口	` Xf
总 出	` X
总 额	` B
总 发电	` oq
总 发	` o
总 格局	` 妲
总 航程	` 璧{
总 合格	` X
总 阶段	` 顶q
总 金额	` 髅B
总 理事会主席	` zㄆ|Du
总 情况	` 薄p
总 支出	` やX
总 主席	` Du
邹 家	Q a
走 出国	ǐ X瓣
走 出来	ǐ Xㄓ
走 东家	ǐ Fa
走 发展	ǐ oi
走 共同	ǐ @P
走 国家	ǐ 瓣a
走 技术	ǐ мN
走 家	ǐ a
走 农家	ǐ Aa
走 农舍	ǐ A
走 亲戚	ǐ 克杯
走 扔下	ǐ サU
走 苏联	ǐ 默p
走 苏	ǐ 默
奏 出	 X
租 发	 o
足 开发	ì }o
族 共产党员	壁 @玻囊
族 共和国	壁 @M瓣
族 技术人员	壁 мNH
族 科学家	壁 炀钱a
族 企业家	壁 ~a
族 世家	壁 @a
族 舞蹈家	壁 R列a
族 专家	壁 Ma
族 作家	壁 @a
祖 列席	 Cu
祖 伦	 
祖 提出	 矗X
祖 指出	 X
阻 动手术	 笆もN
阻 情况	 薄p
组 颁发	舱 {o
组 并	舱 }
组 出	舱 X
组 发出	舱 oX
组 发电	舱 oq
组 共	舱 @
组 合家	舱 Xa
组 塞浦路斯	舱 峨隔吹
组 苏格兰	舱 默婺
组 提出	舱 矗X
组 英格兰	舱 ^婺
钻 采	p 蹦
钻 出来	p Xㄓ
钻 出	p X
嘴 塌方	L 厄よ
最 矮小	程 Gp
最 崇敬	程 Rq
最 出名	程 XW
最 出色	程 X
最 发达	程 oF
最 丰	程 伦
最 坚定	程 绊w
最 坚实	程 绊龟
最 杰出	程 城X
最 紧张	程 候i
最 明显	程 陪
最 突出	程 馥X
罪 斗争	o 矮
左 颈部	オ V场
左 思潮	オ 浼
佐 指出	 X
做 出	暗 X
做 到家	暗 飚a
做 共产党	暗 @玻囊
做 共产主义	暗 @玻Dq
做 合格	暗 X
做 家务	暗 a叭
做 嫁妆	暗 儿З
做 喇嘛	暗 斥估
做 手术	暗 もN
做 移植	暗 簿从
作 采用	@ 蹦ノ
作 测试	@ 代刚
作 出版	@ X
作 当年	@ 讽~
作 斗争	@ 矮
作 发展	@ oi
作 画家	@ ea
作 技术	@ мN
作 坚决	@ 绊M
作 解释	@ 秆睦
作 开发	@ }o
作 老板	@ ρO
作 手术	@ もN
作 宣布	@ 钮
作 学术	@ 厩N
作 预测	@ w代
作 中华人民共和国	@ い地Hチ@M瓣
座 采	y 蹦
座 城市	y 哎
座 国家	y 瓣a
座 敬	y q
座 树木	y 攫れ
座 万里长城	y U姜
座 专家	y Ma
座 专门	y M
鼐 出席	梵 Xu
凫 溪	囗 匪
邰 万	妥 U
圩 堤	f 出
圳 发生	` oネ
圳 签	` 帽
圳 托	` Λ
荪 出席	^ Xu
莅 会	Y |
莅 临	Y {
莅 去	Y h
拚 出来	╅ Xㄓ
拚 技术	╅ мN
拚 战术	╅ 驹N
唠 国家	G 瓣a
唠 自家	G 郛a
岱 有板有眼	┃ ΤOΤ泊
嵘 出	蜡 X
嵋 酒家	剌 sa
庾 澄	h 坚
闫 家	E a
阖 家	麦 a
泔 水桶	挑 舯
泾 开发	 }o
涮 掏出	R 鼻X
妍 斗	О 矮
娴 指出	_ X
婷 并	@ }
尕 布	稍 ガ
驷 列席	o Cu
缫 出	b X
珀 蒂	 甫
珀 和	 M
珀 妮	 g
珩 提出	也 矗X
琪 出席	X Xu
琦 坚决	a 绊M
琦 扑	a 汲
琛 出席	` Xu
琛 指出	` X
栎 树	R 攫
桧 柏树	捞 f攫
桉 树	眼 攫
楣 指出	钒 X
檐 布	姥 ガ
昊 苏	 默
砺 艺术	r 美N
町 发现	m o{
钰 指出	啾 X
稔 秋	Z 
馥 拿出	L 偿X
褚 敬	u q
暨 学术	[ 厩N
踱 出	库 X
雯 拿出	恫 偿X
鑫 发现	 o{
鑫 指出	 X
鬓 发	K o
鼬 舍	^ 
