#g2bword.1.0	15938
阿根廷 的	讧 
阿根廷 等	讧 单
阿根廷 队	讧 钉
阿根廷 谷	讧 é
阿根廷 和	讧 M
阿根廷 梅	讧 宾
阿根廷 驶	讧 p
阿根廷 是	讧 O
阿根廷 同	讧 P
阿根廷 也	讧 ]
阿根廷 与	讧 P
阿根廷 之	讧 ぇ
阿根廷 最	讧 程
阿拉 布	┰ ガ
阿姆斯特丹 的	i吹Sう 
阿姆斯特丹 港	i吹Sう 翠
阿 卜	 R
阿 布	 ガ
阿 伦	 
阿 佩	 ㄘ
埃 布	J ガ
埃 佩	J ㄘ
挨家挨户 地	廉a沥 a
挨家挨户 找	廉a沥 т
挨家挨户 征	廉a沥 ┖
挨家挨户 走	廉a沥 ǐ
哎 呀	u r
癌 疗	砾 励
矮小 的	Gp 
矮 矮	G G
矮 臂	G u
矮 的	G 
矮 杆	G 
矮 个	G 
矮 化	G て
矮 旧	G 侣
矮 马	G 皑
矮 屋	G 
矮 又	G S
艾 卜	 R
艾 格	 
艾 伦	 
艾 默	 q
爱 树	R 攫
安徽 苏	w啦 默
安宁 万	w圭 U
安排 出	w逼 X
安排 发	w逼 o
安全帽 的	wU 
安全 并	w }
安全 出	w X
安然 出	wM X
安置 苏	wm 默
安装 托	w杆 Λ
安 杯	w M
安 格	w 
安 托	w Λ
安 溪	w 匪
俺 家	 a
按照 苏	龇 默
按 布	 ガ
岸 共	─ @
案件 发	抓 o
案件 共	抓 @
案 发	 o
案 万	 U
昂昂 溪	 匪
昂贵 的	Q 
昂贵 是	Q O
昂首 的	 
昂首 于	 _
昂 的	 
昂 等	 单
昂 迪	 }
昂 多	 h
昂 和	 M
昂 将	 N
昂 两	 ㄢ
昂 洛	 
昂 娜	 R
昂 纳	 
昂 内	 ず
昂 起	 _
昂 仁	 く
昂 市	 カ
昂 为	 
昂 席	 u
昂 扬	 喘
盎格鲁撒克逊人 为	s婢|蓟J还H 
敖 伦	蔽 
奥地利 签	而aQ 帽
奥 布	而 ガ
奥 格	而 
奥 共	而 @
奥 伦	而 
奥 托	而 Λ
奥 万	而 U
八 家	K a
八 舍	K 
巴比伦 城	ぺゑ 
巴尔干国家 的	ぺ焊F瓣a 
巴格达 并	ぺ婀F }
巴格达 的	ぺ婀F 
巴格达 电	ぺ婀F q
巴格达 飞	ぺ婀F 
巴格达 和	ぺ婀F M
巴格达 几	ぺ婀F X
巴格达 人	ぺ婀F H
巴格达 以	ぺ婀F H
巴黎 签	ぺ兢 帽
巴西 签	ぺ 帽
巴 卜	ぺ R
巴 布	ぺ ガ
巴 格	ぺ 
巴 伦	ぺ 
巴 苏	ぺ 默
巴 托	ぺ Λ
拔出来 的	┺Xㄓ 
把戏 不	р栏 ぃ
把 发	р o
把 扶	р н
把 共	р @
把 家	р a
把 树	р 攫
把 万	р U
霸权 并	Qv }
罢工 并	}u }
白粉 出	フ X
白色 缎	フ v
白手起家 搞	フも_a d
白手起家 建	フも_a 
白手起家 自	フも_a 
白血病 并	フ瀵f }
白杨 树	フ法 攫
白衣天使 杯	フ绀穴 M
白 布	フ ガ
白 发	フ o
柏树 苗	f攫 ]
柏树 下	f攫 U
柏 秋	f 
百花 杯	κ M
百货 杯	κf M
百日咳 发	κらy o
百万吨 的	κU痉 
百万吨 废	κU痉 o
百万吨 各	κU痉 U
百万吨 煤	κU痉 费
百万富翁 了	κUI F
百万富翁 呢	κUI O
百万 册	κU U
百万 个	κU 
百万 户	κU め
百万 计	κU p
百万 件	κU ン
百万 斤	κU ょ
百万 来	κU ㄓ
百万 旅	κU 
百万 盲	κU 
百万 亩	κU a
百万 年	κU ~
百万 青	κU C
百万 人	κU H
百万 余	κU E
百万 元	κU じ
百万 职	κU 戮
百万 只	κU u
百万 中	κU い
百万 株	κU 
百万 字	κU r
百姓 家	κm a
百元 发	κじ o
百 发	κ o
百 家	κ a
摆 布	\ ガ
摆 出	\ X
败 家	毖 a
班长 邢	Z ǚ
班 出	Z X
班 格	Z 
班 共	Z @
搬家 时	ha 
搬家 在	ha b
颁发 的	{o 
颁发 给	{o 倒
颁发 了	{o F
颁发 林	{o L
颁发 之	{o ぇ
颁 布	{ ガ
板车 从	Oó q
板车 就	Oó N
板机 的	O诀 
板机 下	O诀 U
板机 运	O诀 B
板栗 的	O 
板栗 等	O 单
板栗 青	O C
板栗 收	O Μ
板栗 树	O 攫
板栗 为	O 
板栗 一	O @
板栗 已	O w
板栗 园	O 堕
板门店 同	O┍ P
板门店 向	O┍ V
板球 队	Oy 钉
板条 厂	O兵 t
板 安	O w
板 报	O 厨
板 便	O K
板 材	O 
板 长	O 
板 厂	O t
板 城	O 
板 的	O 
板 地	O a
板 都	O 常
板 管	O 恨
板 和	O M
板 化	O て
板 还	O 临
板 井	O か
板 可	O i
板 刻	O ㄨ
板 块	O 遏
板 链	O 渺
板 林	O L
板 坯	O 蓑
板 皮	O ブ
板 区	O 跋
板 上	O W
板 是	O O
板 头	O Y
板 为	O 
板 相	O 
板 也	O ]
版画 家	┑e a
办公室 共	快そ @
办公厅 发	快そU o
办理 采	快z 蹦
办理 发	快z o
办理 疗	快z 励
办事处 共	快ㄆB @
办 板	快 O
办 出	快 X
办 丰	快 伦
办 扶	快 н
办 婚	快 B
办 敬	快 q
办 托	快 Λ
办 万	快 U
邦 格	ü 
帮办 伦	腊快 
帮助 并	腊U }
帮助 发	腊U o
帮助 扶	腊U н
帮 扶	腊 н
胞 共	M @
胞 签	M 帽
包括 布	]A ガ
薄板 厂	痢O t
薄板 成	痢O Θ
薄板 的	痢O 
薄板 将	痢O N
薄板 冷	痢O N
薄板 品	痢O ~
保持 并	O }
保持 发	O o
保护 焊	O@ k
保证 出	O谍 X
保证 丰	O谍 伦
保证 扶	O谍 н
保 共	O @
保 家	O a
宝 杯	_ M
抱 出	╆ X
报告 并	厨i }
报告 发	厨i o
报名 并	厨W }
报名 参	厨W 把
报名 超	厨W W
报名 到	厨W 
报名 的	厨W 
报名 后	厨W 
报名 剧	厨W @
报名 率	厨W v
报名 期	厨W 戳
报名 人	厨W H
报名 应	厨W 莱
报名 者	厨W 
报 出	厨 X
暴动 中	忌笆 い
暴露 出	忌S X
暴 默	忌 q
爆发 冲	zo R
爆发 出	zo X
爆发 的	zo 
爆发 第	zo 材
爆发 后	zo 
爆发 了	zo F
爆发 流	zo y
爆发 马	zo 皑
爆发 能	zo 
爆发 前	zo e
爆发 时	zo 
爆发 是	zo O
爆发 一	zo @
爆发 这	zo o
爆发 之	zo ぇ
爆炸 并	z }
爆 出	z X
杯 半	M b
杯 伯	M B
杯 茶	M 
杯 大	M j
杯 的	M 
杯 读	M 弄
杯 短	M u
杯 盖	M \
杯 喝	M 耻
杯 和	M M
杯 花	M 
杯 奖	M 贱
杯 敬	M q
杯 酒	M s
杯 老	M ρ
杯 立	M ミ
杯 男	M k
杯 女	M k
杯 软	M n
杯 赛	M 辽
杯 声	M n
杯 首	M 
杯 水	M 
杯 速	M t
杯 穗	M J
杯 土	M g
杯 稳	M 铆
杯 我	M и
杯 业	M ~
杯 以	M H
杯 优	M u
杯 羽	M π
杯 则	M h
杯 这	M o
杯 争	M 
杯 中	M い
悲剧 并	d@ }
悲戚 地	d杯 a
北方 出	_よ X
北京 万	_ㄊ U
北 丰	_ 伦
北 伦	_ 
辈 出	晋 X
背包 带	I] a
背包 袱	I] 钓
背包 踏	I] 今
背道而驰 的	IDτ梗 
背后 的	I 
背后 低	I C
背后 都	I 常
背后 扼	I с
背后 向	I V
背后 一	I @
背景 的	I春 
背景 和	I春 M
背景 及	I春 の
背景 是	I春 O
背景 台	I春 x
背景 下	I春 U
背景 之	I春 ぇ
背景 值	I春 
背面 的	I 
背面 以	I H
背叛 了	Iq F
背水一战 的	I簸@驹 
背心 便	Iみ K
背心 穿	Iみ 
背心 的	Iみ 
背心 和	Iみ M
背心 似	Iみ 
背 阿	I 
背 车	I ó
背 村	I 
背 到	I 
背 等	I 单
背 二	I G
背 飞	I 
背 风	I 
背 回	I ^
背 夹	I Ж
背 进	I i
背 井	I か
背 靠	I a
背 离	I 瞒
背 梁	I 辩
背 篓	I M
背 起	I _
背 气	I 
背 去	I h
背 人	I H
背 山	I s
背 伤	I 端
背 上	I W
背 手	I も
背 熟	I 剪
背 她	I o
背 驼	I m
背 畜	I b
背 已	I w
背 影	I v
背 越	I V
背 在	I b
背 著	I 帝
贝 雕	ī J
贝 格	ī 
贝 共	ī @
贝 托	ī Λ
备用 托	称ノ Λ
备 并	称 }
备 出	称 X
备 签	称 帽
被 逼	Q G
被 并	Q }
被 树	Q 攫
被 塌	Q 厄
被 剃	Q c
被 婉	Q 胞
奔驰 厂	b梗 t
奔驰 车	b梗 ó
奔驰 在	b梗 b
奔 出	b X
本国 家	セ瓣 a
本 格	セ 
本 共	セ @
本 家	セ a
本 溪	セ 匪
崩溃 并	Y检 }
泵 采	 蹦
泵 出	 X
蹦 床	论 
蹦 高	论 蔼
逼近 的	G 
逼 才	G ~
逼 得	G o
逼 和	G M
逼 蒋	G 奖
逼 进	G i
逼 你	G A
逼 平	G キ
逼 其	G ㄤ
逼 抢	G m
逼 人	G H
逼 森	G 此
逼 使	G ㄏ
逼 熟	G 剪
逼 她	G o
逼 退	G h
逼 著	G 帝
逼 走	G ǐ
比不上 邢	ゑぃW ǚ
比较 丰	ゑ耕 伦
比赛场 丰	ゑ辽初 伦
比赛 并	ゑ辽 }
比赛 共	ゑ辽 @
比 昂	ゑ 
比 卜	ゑ R
比 布	ゑ ガ
比 格	ゑ 
比 家	ゑ a
比 舍	ゑ 
比 托	ゑ Λ
笔 共	掸 @
笔 签	掸 帽
彼此 并	┘ }
碧云 杯	貉冻 M
碧 溪	貉 匪
毕竟 并	拨澈 }
闭幕式 并	超辊Α }
必须 发	ゲ斗 o
必须 佩	ゲ斗 ㄘ
必须 签	ゲ斗 帽
必须 托	ゲ斗 Λ
必 家	ゲ a
必 坚	ゲ 绊
辟 出	@ X
壁 雕	纠 J
臂 焊	u k
边 并	娩 }
边 铲	娩 藐
边 扶	娩 н
边 敬	娩 q
编辑部 出	s胯场 X
编辑 家	s胯 a
编制 并	s }
编制 出	s X
编 采	s 蹦
编 出	s X
编 发	s o
扁长 的	螵 
扁担 长	缶 
扁担 与	缶 P
扁 竹	 λ
便 背	K I
便 逼	K G
变化 出	跑て X
变化 万	跑て U
辩驳 的	G婚 
遍 布	M ガ
标价 签	夹基 帽
标 签	夹 帽
表格 后	懋 
表面 涂	憝 额
表明 出	愆 X
表示 出	恁 X
表现 出	聿{ X
表 并	 }
别出心裁 的	OXみ掉 
别具一格 的	Oㄣ@ 
别人 出	OH X
别人 家	OH a
别 出	O X
别 家	O a
斌 出	y X
斌 发	y o
宾格 尔	猾 焊
兵团 共	L刮 @
兵 舍	L 
冰雕 雪	BJ 撤
冰水 漫	B 憨
病人 术	fH N
病 发	f o
病 家	f a
病 疗	f 励
病 塌	f 厄
并 按	} 
并 把	} р
并 颁	} {
并 伴	} 
并 办	} 快
并 帮	} 腊
并 报	} 厨
并 备	} 称
并 被	} Q
并 编	} s
并 标	} 夹
并 拨	} 挤
并 补	} 干
并 不	} ぃ
并 步	} B
并 参	} 把
并 草	} 
并 查	} d
并 产	} 玻
并 抄	} й
并 称	} 嘿
并 成	} Θ
并 呈	} e
并 出	} X
并 处	} B
并 创	} 承
并 从	} q
并 促	} P
并 存	} s
并 打	} ゴ
并 大	} j
并 带	} a
并 代	} N
并 担	} 踞
并 到	} 
并 德	} w
并 得	} o
并 的	} 
并 登	} n
并 吊	} Q
并 定	} w
并 断	} _
并 对	} 癸
并 多	} h
并 夺	} 管
并 额	} B
并 而	} τ
并 发	} o
并 反	} は
并 放	} 
并 非	} D
并 分	} だ
并 辅	} 徊
并 赴	} u
并 附	} 
并 敢	} 幢
并 搞	} d
并 各	} U
并 给	} 倒
并 更	} 
并 公	} そ
并 挂	} 本
并 轨	} y
并 诡	} 皋
并 海	} 
并 核	} 
并 和	} M
并 合	} X
并 很	} 
并 狠	} 
并 虹	} i
并 后	} 
并 呼	} I
并 互	} が
并 还	} 临
并 挥	} 揣
并 会	} |
并 汇	} 蹲
并 绘	} 酶
并 获	} 莉
并 或	} ┪
并 寄	} H
并 计	} p
并 驾	} r
并 肩	} 
并 简	} 虏
并 减	} 搭
并 鉴	} 懦
并 见	} ǎ
并 建	} 
并 将	} N
并 讲	} 量
并 交	} ユ
并 缴	} 煤
并 教	} 毙
并 结	} 挡
并 解	} 秆
并 借	} 
并 进	} i
并 近	} 
并 尽	} 荷
并 经	} g
并 就	} N
并 举	} |
并 具	} ㄣ
并 决	} M
并 均	} А
并 开	} }
并 看	} 
并 可	} i
并 立	} ミ
并 力	} O
并 两	} ㄢ
并 了	} F
并 列	} C
并 留	} d
并 流	} y
并 拢	} l
并 录	} 魁
并 率	} v
并 略	} 菠
并 落	} 辅
并 埋	} I
并 茂	} Z
并 没	} S
并 每	} C
并 免	} K
并 鸣	} 伙
并 名	} W
并 命	} R
并 谋	} 垦
并 拿	} 
并 能	} 
并 拟	} 览
并 派	} 
并 盘	} L
并 判	} P
并 跑	} ]
并 培	} 蚌
并 陪	} 抄
并 配	} t
并 评	} 蝶
并 其	} ㄤ
并 起	} _
并 签	} 帽
并 抢	} m
并 且	} B
并 请	} 叫
并 劝	} U
并 让	} 琵
并 任	} ヴ
并 荣	} a
并 入	} J
并 三	} T
并 摄	} 尼
并 设	} ]
并 时	} 
并 矢	} ペ
并 使	} ㄏ
并 收	} Μ
并 受	} 
并 数	} 计
并 说	} 弧
并 送	} e
并 算	} 衡
并 随	} H
并 所	} ┮
并 抬	} ╋
并 特	} S
并 提	} 矗
并 题	} D
并 体	} 砰
并 同	} P
并 投	} щ
并 推	} 崩
并 吞	} ]
并 托	} Λ
并 网	} 呼
并 往	} ┕
并 为	} 
并 委	} e
并 未	} ゼ
并 无	} L
并 细	} 灿
并 相	} 
并 镶	} ^
并 想	} Q
并 向	} V
并 写	} g
并 新	} s
并 行	} 
并 蓄	} W
并 选	} 匡
并 严	} Y
并 研	} 
并 要	} n
并 也	} ]
并 一	} @
并 依	} ㄌ
并 已	} w
并 以	} H
并 译	} 亩
并 因	} ]
并 涌	} F
并 用	} ノ
并 由	} パ
并 有	} Τ
并 于	} _
并 予	} ぉ
并 与	} P
并 吁	} S
并 远	} 环
并 愿	} @
并 运	} B
并 在	} b
并 责	} d
并 曾	} 纯
并 展	} i
并 战	} 驹
并 这	} o
并 征	} ┖
并 正	} タ
并 志	} в
并 致	} P
并 制	} 
并 终	} 沧
并 重	} 
并 主	} D
并 注	} `
并 祝	} 
并 转	} 锣
并 准	} 
并 走	} ǐ
并 做	} 暗
并 作	} @
玻璃板 下	良O U
播放 的	冀 
播放 和	冀 M
播放 了	冀 F
播放 他	冀 L
播放 新	冀 s
播放 影	冀 v
播 出	冀 X
播 发	冀 o
拨款 并	挤蹿 }
拨款 额	挤蹿 B
拨 出	挤 X
波尔 采	i焊 蹦
波尔 托	i焊 Λ
波 并	i }
波 格	i 
波 苏	i 默
博士学位 并	痴h厩 }
博物馆 并	痴] }
博 采	痴 蹦
博 格	痴 
博 托	痴 Λ
勃 发	k o
勃 伦	k 
搏斗 的	i矮 
搏斗 了	i矮 F
搏斗 三	i矮 T
搏斗 时	i矮 
搏斗 受	i矮 
搏斗 中	i矮 い
伯 杯	B M
伯 格	B 
伯 伦	B 
伯 托	B Λ
驳斥 丁	婚ジ B
驳斥 关	婚ジ 闽
驳斥 老	婚ジ ρ
驳斥 了	婚ジ F
卜 达	R F
卜 道	R D
卜 等	R 单
卜 杜	R 
卜 会	R |
卜 杰	R 城
卜 拉	R ┰
卜 恰	R 
卜 素	R 
卜 一	R @
卜 余	R E
卜 玉	R ド
卜 昭	R L
卜 之	R ぇ
补选 出	干匡 X
补助 额	干U B
补 发	干 o
补 树	干 攫
不到 出	ぃ X
不到 额	ぃ B
不断 出	ぃ_ X
不断 丰	ぃ_ 伦
不断 汲	ぃ_ V
不法之徒 的	ぃkぇ{ 
不法之徒 在	ぃkぇ{ b
不及 格	ぃの 
不见 串	ぃǎ 
不见 树	ぃǎ 攫
不结盟国家 和	ぃ挡幅瓣a M
不结盟国家 应	ぃ挡幅瓣a 莱
不仅 发	ぃ度 o
不仅 家	ぃ度 a
不适 并	ぃA }
不再 签	ぃA 帽
不足 并	ぃì }
不 出	ぃ X
不 发	ぃ o
不 丰	ぃ 伦
不 佩	ぃ ㄘ
不 签	ぃ 帽
不 舍	ぃ 
布达佩斯 的	ガFㄘ吹 
布达佩斯 为	ガFㄘ吹 
布达佩斯 最	ガFㄘ吹 程
布袋戏 和	ガU栏 M
布袋 里	ガU 
布拉格 查	ガ┰ d
布拉格 的	ガ┰ 
布拉格 和	ガ┰ M
布拉格 老	ガ┰ ρ
布料 和	ガ M
布料 一	ガ @
布林 卡	ガL d
布鲁塞尔 的	ガ|峨焊 
布鲁塞尔 和	ガ|峨焊 M
布鲁塞尔 就	ガ|峨焊 N
布鲁塞尔 市	ガ|峨焊 カ
布鲁塞尔 同	ガ|峨焊 P
布施 的	ガI 
布署 到	ガp 
布署 在	ガp b
布鞋 厂	ガc t
布鞋 等	ガc 单
布鞋 在	ガc b
布宜诺斯艾利斯 的	ガy空吹悃Q吹 
布宜诺斯艾利斯 和	ガy空吹悃Q吹 M
布宜诺斯艾利斯 同	ガy空吹悃Q吹 P
布置 成	ガm Θ
布置 的	ガm 
布置 缉	ガm r
布置 评	ガm 蝶
布置 图	ガm 瓜
布置 新	ガm s
布置 一	ガm @
布置 在	ガm b
布置 这	ガm o
布 阿	ガ 
布 埃	ガ J
布 便	ガ K
布 勃	ガ k
布 不	ガ ぃ
布 厂	ガ t
布 城	ガ 
布 成	ガ Θ
布 次	ガ Ω
布 搭	ガ f
布 达	ガ F
布 带	ガ a
布 当	ガ 讽
布 到	ガ 
布 道	ガ D
布 德	ガ w
布 的	ガ 
布 等	ガ 单
布 迪	ガ }
布 第	ガ 材
布 点	ガ I
布 杜	ガ 
布 对	ガ 癸
布 尔	ガ 焊
布 范	ガ S
布 防	ガ 
布 放	ガ 
布 干	ガ F
布 革	ガ 
布 格	ガ 
布 各	ガ U
布 公	ガ そ
布 哈	ガ 
布 汗	ガ 
布 和	ガ M
布 赫	ガ 划
布 很	ガ 
布 后	ガ 
布 基	ガ 膀
布 及	ガ の
布 贾	ガ 鸽
布 江	ガ 
布 局	ガ Ы
布 卡	ガ d
布 科	ガ 
布 可	ガ i
布 克	ガ J
布 拉	ガ ┰
布 莱	ガ 弟
布 赖	ガ 苦
布 兰	ガ 孽
布 缆	ガ l
布 朗	ガ 
布 勒	ガ 扒
布 雷	ガ p
布 里	ガ 
布 利	ガ Q
布 力	ガ O
布 了	ガ F
布 列	ガ C
布 隆	ガ 订
布 卢	ガ c
布 鲁	ガ |
布 吕	ガ f
布 伦	ガ 
布 罗	ガ 霉
布 洛	ガ 
布 满	ガ 骸
布 盟	ガ 幅
布 纳	ガ 
布 棚	ガ 醋
布 匹	ガ で
布 前	ガ e
布 切	ガ ち
布 钦	ガ 窜
布 琴	ガ ^
布 琼	ガ 茫
布 穷	ガ a
布 区	ガ 跋
布 全	ガ 
布 仁	ガ く
布 萨	ガ 履
布 塞	ガ 峨
布 赛	ガ 辽
布 三	ガ T
布 散	ガ 床
布 山	ガ s
布 衫	ガ m
布 设	ガ ]
布 省	ガ 
布 时	ガ 
布 什	ガ ぐ
布 是	ガ O
布 氏	ガ ん
布 说	ガ 弧
布 斯	ガ 吹
布 寺	ガ x
布 苏	ガ 默
布 特	ガ S
布 提	ガ 矗
布 条	ガ 兵
布 同	ガ P
布 图	ガ 瓜
布 托	ガ Λ
布 瓦	ガ ニ
布 韦	ガ 
布 为	ガ 
布 下	ガ U
布 谢	ガ 谅
布 亚	ガ ㄈ
布 也	ガ ]
布 一	ガ @
布 依	ガ ㄌ
布 衣	ガ 
布 已	ガ w
布 由	ガ パ
布 于	ガ _
布 与	ガ P
布 约	ガ 
布 在	ガ b
布 增	ガ W
布 扎	ガ 蚕
布 遮	ガ B
布 这	ガ o
布 政	ガ F
布 之	ガ ぇ
布 制	ガ 
布 著	ガ 帝
布 兹	ガ 
布 总	ガ `
布 做	ガ 暗
步 出	B X
步 扑	B 汲
部长 布	场 ガ
部长 共	场 @
部长 佩	场 ㄘ
部长 戚	场 杯
部长 托	场 Λ
部队 并	场钉 }
部队 出	场钉 X
部队 发	场钉 o
部队 共	场钉 @
部分 并	场だ }
部分 出	场だ X
部门 并	场 }
部门 出	场 X
部门 发	场 o
部门 共	场 @
部门 签	场 帽
部 发	场 o
部 共	场 @
部 戚	场 杯
猜 共	q @
裁军 并	掉x }
材料 发	鳟 o
材料 丰	鳟 伦
材 丰	 伦
材 树	 攫
才能 昂	~ 
才能 出	~ X
才 背	~ I
才 并	~ }
才 发	~ o
才 家	~ a
财务状况 更	]叭p 
财政部长 布	]F场 ガ
财政部长 佩	]F场 ㄘ
财政部 共	]F场 @
财 发	] o
采访 安	蹦X w
采访 吧	蹦X a
采访 报	蹦X 厨
采访 笔	蹦X 掸
采访 陈	蹦X 朝
采访 到	蹦X 
采访 的	蹦X 
采访 复	蹦X _
采访 过	蹦X L
采访 和	蹦X M
采访 后	蹦X 
采访 赖	蹦X 苦
采访 两	蹦X ㄢ
采访 了	蹦X F
采访 录	蹦X 魁
采访 某	蹦X Y
采访 前	蹦X e
采访 却	蹦X o
采访 人	蹦X H
采访 散	蹦X 床
采访 时	蹦X 
采访 是	蹦X O
采访 宋	蹦X Ш
采访 他	蹦X L
采访 她	蹦X o
采访 完	蹦X Ч
采访 越	蹦X V
采访 张	蹦X i
采访 这	蹦X o
采访 证	蹦X 谍
采访 中	蹦X い
采购 到	蹦潦 
采购 的	蹦潦 
采购 柑	蹦潦 a
采购 和	蹦潦 M
采购 及	蹦潦 の
采购 也	蹦潦 ]
采购 员	蹦潦 
采购 制	蹦潦 
采购 中	蹦潦 い
采光 面	蹦 
采集 半	蹦栋 b
采集 的	蹦栋 
采集 基	蹦栋 膀
采集 卡	蹦栋 d
采集 了	蹦栋 F
采集 树	蹦栋 攫
采集 业	蹦栋 ~
采集 自	蹦栋 
采掘 的	蹦备 
采掘 工	蹦备 u
采掘 业	蹦备 ~
采矿 厂	蹦q t
采矿 的	蹦q 
采矿 等	蹦q 单
采矿 范	蹦q S
采矿 和	蹦q M
采矿 及	蹦q の
采矿 三	蹦q T
采矿 审	蹦q f
采矿 为	蹦q 
采矿 业	蹦q ~
采矿 有	蹦q Τ
采纳 的	蹦 
采纳 后	蹦 
采纳 或	蹦 ┪
采纳 了	蹦 F
采取 办	蹦 快
采取 帮	蹦 腊
采取 边	蹦 娩
采取 拨	蹦 挤
采取 补	蹦 干
采取 不	蹦 ぃ
采取 长	蹦 
采取 厂	蹦 t
采取 城	蹦 
采取 此	蹦 
采取 从	蹦 q
采取 大	蹦 j
采取 党	蹦 囊
采取 得	蹦 o
采取 的	蹦 
采取 低	蹦 C
采取 冬	蹦 V
采取 对	蹦 癸
采取 多	蹦 h
采取 反	蹦 は
采取 防	蹦 
采取 分	蹦 だ
采取 干	蹦 F
采取 高	蹦 蔼
采取 各	蹦 U
采取 更	蹦 
采取 公	蹦 そ
采取 和	蹦 M
采取 何	蹦 
采取 很	蹦 
采取 会	蹦 |
采取 几	蹦 X
采取 既	蹦 J
采取 加	蹦 [
采取 简	蹦 虏
采取 较	蹦 耕
采取 节	蹦 `
采取 两	蹦 ㄢ
采取 了	蹦 F
采取 六	蹦 せ
采取 哪	蹦 
采取 那	蹦 ê
采取 排	蹦 逼
采取 气	蹦 
采取 枪	蹦 j
采取 让	蹦 琵
采取 若	蹦 Y
采取 三	蹦 T
采取 上	蹦 W
采取 省	蹦 
采取 什	蹦 ぐ
采取 使	蹦 ㄏ
采取 树	蹦 攫
采取 脱	蹦 叉
采取 为	蹦 
采取 五	蹦 き
采取 先	蹦 
采取 限	蹦 
采取 向	蹦 V
采取 新	蹦 s
采取 选	蹦 匡
采取 学	蹦 厩
采取 扬	蹦 喘
采取 一	蹦 @
采取 以	蹦 H
采取 用	蹦 ノ
采取 优	蹦 u
采取 有	蹦 Τ
采取 与	蹦 P
采取 在	蹦 b
采取 增	蹦 W
采取 扎	蹦 蚕
采取 这	蹦 o
采取 征	蹦 ┖
采取 自	蹦 
采取 纵	蹦 a
采取 最	蹦 程
采用 按	蹦ノ 
采用 百	蹦ノ κ
采用 并	蹦ノ }
采用 插	蹦ノ 础
采用 筹	蹦ノ w
采用 磁	蹦ノ 合
采用 从	蹦ノ q
采用 催	蹦ノ 妒
采用 大	蹦ノ j
采用 单	蹦ノ 虫
采用 的	蹦ノ 
采用 低	蹦ノ C
采用 洞	蹦ノ }
采用 端	蹦ノ 狠
采用 多	蹦ノ h
采用 俯	蹦ノ 
采用 该	蹦ノ 赣
采用 概	蹦ノ 阀
采用 钢	蹦ノ 葵
采用 高	蹦ノ 蔼
采用 光	蹦ノ 
采用 核	蹦ノ 
采用 何	蹦ノ 
采用 红	蹦ノ 
采用 还	蹦ノ 临
采用 获	蹦ノ 莉
采用 或	蹦ノ ┪
采用 聚	蹦ノ E
采用 来	蹦ノ ㄓ
采用 良	蹦ノ }
采用 两	蹦ノ ㄢ
采用 了	蹦ノ F
采用 磷	蹦ノ C
采用 六	蹦ノ せ
采用 率	蹦ノ v
采用 轮	蹦ノ 近
采用 煤	蹦ノ 费
采用 明	蹦ノ 
采用 全	蹦ノ 
采用 三	蹦ノ T
采用 深	蹦ノ `
采用 什	蹦ノ ぐ
采用 缩	蹦ノ Y
采用 体	蹦ノ 砰
采用 透	蹦ノ z
采用 微	蹦ノ L
采用 我	蹦ノ и
采用 硝	蹦ノ v
采用 小	蹦ノ p
采用 新	蹦ノ s
采用 悬	蹦ノ a
采用 氧	蹦ノ 
采用 一	蹦ノ @
采用 异	蹦ノ 钵
采用 原	蹦ノ 
采用 载	蹦ノ 更
采用 择	蹦ノ 拒
采用 粘	蹦ノ 诌
采用 者	蹦ノ 
采用 这	蹦ノ o
采用 中	蹦ノ い
采用 重	蹦ノ 
采用 祖	蹦ノ 
采摘 后	蹦K 
采自 深	蹦 `
采 办	蹦 快
采 备	蹦 称
采 出	蹦 X
采 储	蹦 x
采 的	蹦 
采 栋	蹦 瓷
采 队	蹦 钉
采 恩	蹦 
采 伐	蹦 ワ
采 风	蹦 
采 夫	蹦 ひ
采 富	蹦 I
采 古	蹦 j
采 和	蹦 M
采 回	蹦 ^
采 金	蹦 
采 进	蹦 i
采 空	蹦 
采 滥	蹦 垒
采 两	蹦 ㄢ
采 烈	蹦 P
采 率	蹦 v
采 罗	蹦 霉
采 买	蹦 R
采 煤	蹦 费
采 蜜	蹦 e
采 暖	蹦 x
采 七	蹦 C
采 区	蹦 跋
采 三	蹦 T
采 声	蹦 n
采 石	蹦 ホ
采 收	蹦 Μ
采 四	蹦 |
采 穗	蹦 J
采 所	蹦 ┮
采 塔	蹦 娥
采 挖	蹦 
采 为	蹦 
采 写	蹦 g
采 选	蹦 匡
采 盐	蹦 Q
采 样	蹦 妓
采 冶	蹦 M
采 由	蹦 パ
采 油	蹦 o
采 育	蹦 |
采 运	蹦 B
采 照	蹦 酚
采 珍	蹦 
采 种	蹦 贺
采 拮	蹦 
采 撷	蹦 ^
菜篮子 丰	垫xl 伦
蔡 家	讲 a
蔡 伦	讲 
餐饮部 的	\都场 
参观 万	把[ U
参加 扶	把[ н
参加 共	把[ @
参加 苏	把[ 默
参天 大	把ぱ j
参与 签	把P 帽
残 匪	摧 
残 迹	摧 格
残 舍	摧 
苍 树	a 攫
仓库 签	墚w 帽
藏 布	旅 ガ
藏 丰	旅 伦
操作系统 及	巨@t参 の
操作 苏	巨@ 默
曹 树	变 攫
曹 婉	变 胞
草案 把	螽 р
草案 并	螽 }
草案 不	螽 ぃ
草案 除	螽 埃
草案 的	螽 
草案 等	螽 单
草案 都	螽 常
草案 更	螽 
草案 和	螽 M
草案 后	螽 
草案 还	螽 临
草案 及	螽 の
草案 将	螽 N
草案 交	螽 ユ
草案 上	螽 W
草案 时	螽 
草案 是	螽 O
草案 提	螽 矗
草案 体	螽 砰
草案 同	螽 P
草案 也	螽 ]
草案 已	螽 w
草案 以	螽 H
草案 有	螽 Τ
草案 与	螽 P
草案 在	螽 b
草案 曾	螽 纯
草案 征	螽 ┖
草案 中	螽 い
草案 做	螽 暗
草案 作	螽 @
草地 共	螃a @
草 签	 帽
草 舍	 
策 伦	郸 
侧 扑	凹 汲
册 发	U o
册 共	U @
测试 并	代刚 }
测试 出	代刚 X
测试 的	代刚 
测试 等	代刚 单
测试 点	代刚 I
测试 和	代刚 M
测试 很	代刚 
测试 后	代刚 
测试 会	代刚 |
测试 鉴	代刚 懦
测试 时	代刚 
测试 仪	代刚 祸
测试 应	代刚 莱
测试 于	代刚 _
测试 与	代刚 P
测试 准	代刚 
测试 总	代刚 `
测试 做	代刚 暗
测 出	代 X
层层 签	hh 帽
层出不穷 的	hXぃa 
层次 丰	hΩ 伦
层 共	h @
插秧机 和	础本 M
插秧 的	础 
插秧 近	础 
插秧 时	础 
插秧 用	础 ノ
茶杯 粗	M 彩
茶杯 大	M j
茶杯 笑	M 
茶杯 子	M l
查出来 是	dXㄓ O
查出 奥	dX 而
查出 不	dX ぃ
查出 的	dX 
查出 各	dX U
查出 金	dX 
查出 科	dX 
查出 了	dX F
查出 哪	dX 
查出 私	dX p
查出 偷	dX 敖
查出 违	dX H
查出 一	dX @
查出 易	dX 
查出 应	dX 莱
查 布	d ガ
察 布	诡 ガ
差额 比	tB ゑ
差额 的	tB 
差额 很	tB 
差 共	t @
柴油发电 机	悛ooq 诀
搀扶 起	eн _
搀扶 下	eн U
搀扶 著	eн 帝
铲车 不	藐ó ぃ
铲车 效	藐ó 
铲 边	藐 娩
铲 铲	藐 藐
铲 除	藐 埃
铲 掉	藐 奔
铲 去	藐 h
铲 土	藐 g
铲 我	藐 и
铲 雪	藐 撤
产品 并	玻~ }
产品 出	玻~ X
产品 共	玻~ @
产生 出	玻ネ X
产业 并	玻~ }
产业 布	玻~ ガ
产 出	玻 X
产 丰	玻 伦
产 万	玻 U
阐述 苏	哪z 默
场 丰	初 伦
场 扶	初 н
场 漫	初 憨
场 万	初 U
常青 树	`C 攫
长城 杯	 M
长春 树	K 攫
长颈鹿 和	V忱 M
长 出	 X
长 堤	 出
长 发	 o
长 丰	 伦
长 敬	 q
长 万	 U
长 邢	 ǚ
偿还 额	v临 B
厂长 共	t @
厂 板	t O
厂 采	t 蹦
厂 共	t @
厂 汲	t V
厂 家	t a
厂 签	t 帽
唱 出	佰 X
倡导 并	揖 }
超出 百	WX κ
超出 本	WX セ
超出 基	WX 膀
超出 捷	WX 倍
超出 近	WX 
超出 两	WX ㄢ
超出 了	WX F
超出 它	WX ウ
超出 暂	WX 既
超额 百	WB κ
超额 交	WB ユ
超额 了	WB F
超过 伦	WL 
超过 万	WL U
超 丰	W 伦
超 共	W @
朝发夕至 的	绰oi 
朝 签	绰 帽
朝 苏	绰 默
车胎 出	óL X
车 共	ó @
车 况	ó p
扯 布	ц ガ
撤出 百	MX κ
撤出 被	MX Q
撤出 的	MX 
撤出 古	MX j
撤出 后	MX 
撤出 几	MX X
撤出 捷	MX 倍
撤出 黎	MX 兢
撤出 两	MX ㄢ
撤出 了	MX F
撤出 南	MX n
撤出 其	MX ㄤ
撤出 侵	MX I
撤出 去	MX h
撤出 沙	MX F
撤出 苏	MX 默
撤出 所	MX ┮
撤出 它	MX ウ
撤出 同	MX P
撤出 为	MX 
撤出 有	MX Τ
撤出 驻	MX n
撤离 布	M瞒 ガ
撤 并	M }
彻底 铲	过┏ 藐
沉默 不	Iq ぃ
陈 发	朝 o
陈 丰	朝 伦
陈 家	朝 a
陈 坚	朝 绊
陈 佩	朝 ㄘ
陈 树	朝 攫
陈 苏	朝 默
陈 婉	朝 胞
衬 布	浓 ガ
称为 苏	嘿 默
称赞 苏	嘿g 默
称 苏	嘿 默
城市 阿	哎 
城市 艾	哎 
城市 安	哎 w
城市 按	哎 
城市 奥	哎 而
城市 百	哎 κ
城市 班	哎 Z
城市 办	哎 快
城市 比	哎 ゑ
城市 彼	哎 ┘
城市 编	哎 s
城市 布	哎 ガ
城市 长	哎 
城市 筹	哎 w
城市 达	哎 F
城市 大	哎 j
城市 待	哎 
城市 丹	哎 う
城市 到	哎 
城市 德	哎 w
城市 的	哎 
城市 都	哎 常
城市 对	哎 癸
城市 费	哎 O
城市 戈	哎 む
城市 共	哎 @
城市 关	哎 闽
城市 呵	哎 
城市 和	哎 M
城市 红	哎 
城市 后	哎 
城市 还	哎 临
城市 或	哎 ┪
城市 及	哎 の
城市 几	哎 X
城市 加	哎 [
城市 建	哎 
城市 金	哎 
城市 近	哎 
城市 就	哎 N
城市 举	哎 |
城市 均	哎 А
城市 卡	哎 d
城市 开	哎 }
城市 凯	哎 惩
城市 抗	哎 к
城市 拉	哎 ┰
城市 里	哎 
城市 两	哎 ㄢ
城市 鲁	哎 |
城市 绿	哎 厚
城市 罗	哎 霉
城市 洛	哎 
城市 马	哎 皑
城市 吗	哎 盾
城市 贸	哎 T
城市 蒙	哎 X
城市 模	哎 家
城市 乃	哎 D
城市 奶	哎 イ
城市 南	哎 n
城市 诺	哎 空
城市 欧	哎 稼
城市 排	哎 逼
城市 普	哎 炊
城市 千	哎 d
城市 前	哎 e
城市 缺	哎 
城市 群	哎 s
城市 燃	哎 U
城市 人	哎 H
城市 塞	哎 峨
城市 上	哎 W
城市 圣	哎 t
城市 是	哎 O
城市 数	哎 计
城市 斯	哎 吹
城市 宿	哎 J
城市 同	哎 P
城市 图	哎 瓜
城市 外	哎 ~
城市 万	哎 U
城市 为	哎 
城市 委	哎 e
城市 污	哎 γ
城市 悉	哎 x
城市 向	哎 V
城市 小	哎 p
城市 新	哎 s
城市 型	哎 
城市 学	哎 厩
城市 亚	哎 ㄈ
城市 要	哎 n
城市 耶	哎 C
城市 也	哎 ]
城市 伊	哎 レ
城市 遗	哎 框
城市 已	哎 w
城市 以	哎 H
城市 用	哎 ノ
城市 由	哎 パ
城市 有	哎 Τ
城市 与	哎 P
城市 远	哎 环
城市 在	哎 b
城市 正	哎 タ
城市 之	哎 ぇ
城市 职	哎 戮
城市 直	哎 
城市 中	哎 い
城市 朱	哎 Χ
城市 总	哎 `
城市 做	哎 暗
城 格	 
城 漫	 憨
城 签	 帽
城 万	 U
城 妆	 З
成本 并	Θセ }
成材 树	Θ 攫
成串 的	Θ 
成份 并	Θ }
成功 并	Θ\ }
成交 额	Θユ B
成立 发	Θミ o
成千上万 的	ΘdWU 
成千上万 个	ΘdWU 
成千上万 名	ΘdWU W
成千上万 南	ΘdWU n
成千上万 项	ΘdWU 兜
成人教育 并	ΘH毙| }
成 并	Θ }
成 额	Θ B
成 家	Θ a
成 坚	Θ 绊
呈现 出	e{ X
程 并	{ }
程 共	{ @
程 家	{ a
程 万	{ U
澄清 了	坚M F
澄清 这	坚M o
澄清 争	坚M 
澄 澄	坚 坚
澄 的	坚 
澄 还	坚 临
澄 庆	坚 y
澄 渝	坚 袋
澄 在	坚 b
承包 采	┯] 蹦
承担 并	┯踞 }
承德 杯	┯w M
承认 并	┯{ }
承先启后 的	┯币 
承 佩	┯ ㄘ
吃 出	Y X
痴呆 的	扶b 
痴呆 儿	扶b ㄠ
痴 劲	扶 l
痴 情	扶 薄
痴 如	扶 p
痴 心	扶 み
持家 务	a 叭
持家 应	a 莱
持续 丰	尿 伦
持 坚	 绊
迟 婚	筐 B
赤字 并	ír }
充分 发	Rだ o
充足 并	Rì }
冲 出	R X
冲 塌	R 厄
崇敬 的	Rq 
崇敬 和	Rq M
崇敬 之	Rq ぇ
崇 伦	R 
崇 托	R Λ
抽出 顶	┾X 郴
抽出 来	┾X ㄓ
抽出 了	┾X F
抽出 些	┾X ㄇ
抽出 一	┾X @
抽 签	┾ 帽
愁 丰	T 伦
绸 缎	瑚 v
初出茅庐 的	欹XTf 
初级产品价格 过	殳挪＋~基 L
初中 共	欷 @
初 发	 o
出版家 和	X┊a M
出版商 的	X┌ 
出版社 把	X┆ р
出版社 补	X┆ 干
出版社 除	X┆ 埃
出版社 从	X┆ q
出版社 的	X┆ 
出版社 等	X┆ 单
出版社 给	X┆ 倒
出版社 共	X┆ @
出版社 和	X┆ M
出版社 还	X┆ 临
出版社 将	X┆ N
出版社 仅	X┆ 度
出版社 近	X┆ 
出版社 看	X┆ 
出版社 录	X┆ 魁
出版社 仍	X┆ ご
出版社 首	X┆ 
出版社 为	X┆ 
出版社 向	X┆ V
出版社 写	X┆ g
出版社 新	X┆ s
出版社 选	X┆ 匡
出版社 要	X┆ n
出版社 已	X┆ w
出版社 亦	X┆ ョ
出版社 应	X┆ 莱
出版社 用	X┆ ノ
出版社 有	X┆ Τ
出版社 于	X┆ _
出版社 在	X┆ b
出版社 则	X┆ h
出版社 之	X┆ ぇ
出版社 主	X┆ D
出版社 自	X┆ 
出版社 组	X┆ 舱
出版物 的	X┆ 
出版物 等	X┆ 单
出版物 使	X┆ ㄏ
出版者 和	X┆ M
出版者 说	X┆ 弧
出版 报	X 厨
出版 的	X 
出版 等	X 单
出版 对	X 癸
出版 方	X よ
出版 非	X D
出版 该	X 赣
出版 和	X M
出版 后	X 
出版 界	X 
出版 局	X Ы
出版 跨	X 阁
出版 了	X F
出版 难	X 螟
出版 史	X v
出版 是	X O
出版 署	X p
出版 题	X D
出版 无	X L
出版 业	X ~
出版 一	X @
出版 这	X o
出版 之	X ぇ
出版 专	X M
出版 总	X `
出版 暨	X [
出兵 干	XL F
出兵 员	XL 
出差 补	Xt 干
出差 错	Xt 岿
出差 的	Xt 
出差 都	Xt 常
出差 去	Xt h
出差 在	Xt b
出产 的	X玻 
出产 品	X玻 ~
出产 生	X玻 ネ
出场 的	X初 
出场 地	X初 a
出场 就	X初 N
出场 献	X初 m
出超 薄	XW 痢
出超 导	XW 旧
出超 高	XW 蔼
出动 了	X笆 F
出动 上	X笆 W
出动 数	X笆 计
出动 在	X笆 b
出动 直	X笆 
出发点 和	XoI M
出发点 是	XoI O
出发 的	Xo 
出发 了	Xo F
出发 前	Xo e
出发 时	Xo 
出发 在	Xo b
出风头 的	X防Y 
出港 接	X翠 钡
出国 到	X瓣 
出国 际	X瓣 悔
出国 讲	X瓣 量
出国 门	X瓣 
出国 内	X瓣 ず
出国 培	X瓣 蚌
出国 研	X瓣 
出国 优	X瓣 u
出海 接	X 钡
出汗 珠	X ]
出乎意料 地	XGN a
出乎 人	XG H
出乎 他	XG L
出乎 主	XG D
出家 门	Xa 
出嫁 的	X儿 
出嫁 女	X儿 k
出嫁 时	X儿 
出借 信	X H
出境 案	X挂 
出境 的	X挂 
出境 等	X挂 单
出境 地	X挂 a
出境 后	X挂 
出境 人	X挂 H
出境 者	X挂 
出口货 源	Xff 方
出口贸易 的	XfT 
出口贸易 六	XfT せ
出口贸易 中	XfT い
出口配额 的	XftB 
出口商 或	Xf坝 ┪
出口商 品	Xf坝 ~
出口 抱	Xf ╆
出口 比	Xf ゑ
出口 便	Xf K
出口 标	Xf 夹
出口 并	Xf }
出口 补	Xf 干
出口 茶	Xf 
出口 产	Xf 玻
出口 超	Xf W
出口 创	Xf 承
出口 达	Xf F
出口 大	Xf j
出口 到	Xf 
出口 的	Xf 
出口 等	Xf 单
出口 定	Xf w
出口 豆	Xf ě
出口 段	Xf q
出口 对	Xf 癸
出口 额	Xf B
出口 份	Xf 
出口 共	Xf @
出口 国	Xf 瓣
出口 和	Xf M
出口 换	Xf 传
出口 活	Xf 
出口 或	Xf ┪
出口 及	Xf の
出口 既	Xf J
出口 价	Xf 基
出口 将	Xf N
出口 净	Xf b
出口 就	Xf N
出口 居	Xf ~
出口 看	Xf 
出口 可	Xf i
出口 宽	Xf e
出口 扩	Xf X
出口 来	Xf ㄓ
出口 哩	Xf 
出口 连	Xf s
出口 量	Xf q
出口 了	Xf F
出口 列	Xf C
出口 铝	Xf T
出口 率	Xf v
出口 猛	Xf r
出口 免	Xf K
出口 能	Xf 
出口 农	Xf A
出口 品	Xf ~
出口 洽	Xf 
出口 却	Xf o
出口 势	Xf 墩
出口 是	Xf O
出口 收	Xf Μ
出口 受	Xf 
出口 数	Xf 计
出口 铜	Xf 簧
出口 退	Xf h
出口 危	Xf M
出口 为	Xf 
出口 鲜	Xf A
出口 效	Xf 
出口 新	Xf s
出口 信	Xf H
出口 型	Xf 
出口 也	Xf ]
出口 业	Xf ~
出口 一	Xf @
出口 已	Xf w
出口 以	Xf H
出口 硬	Xf w
出口 有	Xf Τ
出口 又	Xf S
出口 约	Xf 
出口 跃	Xf D
出口 再	Xf A
出口 在	Xf b
出口 占	Xf 
出口 这	Xf o
出口 之	Xf ぇ
出口 值	Xf 
出口 至	Xf 
出口 制	Xf 
出口 中	Xf い
出口 自	Xf 
出口 总	Xf `
出来 把	Xㄓ р
出来 的	Xㄓ 
出来 都	Xㄓ 常
出来 后	Xㄓ 
出来 哩	Xㄓ 
出来 了	Xㄓ F
出来 满	Xㄓ 骸
出来 呢	Xㄓ O
出来 请	Xㄓ 叫
出来 让	Xㄓ 琵
出来 是	Xㄓ O
出来 说	Xㄓ 弧
出来 同	Xㄓ P
出来 一	Xㄓ @
出来 已	Xㄓ w
出来 又	Xㄓ S
出类拔萃 而	X摸┺笛 τ
出力 的	XO 
出力 和	XO M
出力 就	XO N
出力 献	XO m
出笼 的	X泞 
出路 不	X隔 ぃ
出路 的	X隔 
出路 和	X隔 M
出路 是	X隔 O
出路 外	X隔 ~
出路 在	X隔 b
出路 怎	X隔 
出路 只	X隔 u
出路 子	X隔 l
出乱子 的	X睹l 
出卖 方	X芥 よ
出毛病 再	Xをf A
出没 的	XS 
出没 几	XS X
出没 于	XS _
出没 在	XS b
出门 朝	X 绰
出门 或	X ┪
出门 来	X ㄓ
出门 了	X F
出门 买	X R
出门 请	X 叫
出门 去	X h
出门 外	X ~
出门 要	X n
出面 吵	X n
出面 将	X N
出面 向	X V
出面 依	X ㄌ
出名 并	XW }
出名 次	XW Ω
出名 的	XW 
出名 老	XW ρ
出名 片	XW 
出品 率	X~ v
出其不意 地	XㄤぃN a
出奇 的	X_ 
出奇 迹	X_ 格
出钱 出	X窥 X
出钱 的	X窥 
出钱 太	X窥 び
出勤率 达	X对v F
出勤率 和	X对v M
出勤率 仍	X对v ご
出去 才	Xh ~
出去 当	Xh 讽
出去 的	Xh 
出去 订	Xh q
出去 而	Xh τ
出去 了	Xh F
出去 让	Xh 琵
出去 玩	Xh 
出去 又	Xh S
出去 找	Xh т
出让 金	X琵 
出让 试	X琵 刚
出人意料 的	XHN 
出人意料 地	XHN a
出人意外 的	XHN~ 
出入 境	XJ 挂
出入 南	XJ n
出入 七	XJ C
出入 这	XJ o
出赛 道	X辽 D
出赛 的	X辽 
出色 成	X Θ
出色 的	X 
出色 地	X a
出身 党	Xō 囊
出身 的	Xō 
出身 于	Xō _
出身 在	Xō b
出神入化 中	XJて い
出声 就	Xn N
出生率 比	Xネv ゑ
出生率 从	Xネv q
出生率 大	Xネv j
出生率 的	Xネv 
出生率 低	Xネv C
出生率 和	Xネv M
出生率 降	Xネv 
出生率 千	Xネv d
出生率 仍	Xネv ご
出生率 为	Xネv 
出生率 已	Xネv w
出生率 由	Xネv パ
出生前 就	Xネe N
出生入死 的	XネJ 
出生 的	Xネ 
出生 多	Xネ h
出生 刚	Xネ 
出生 几	Xネ X
出生 仅	Xネ 度
出生 精	Xネ 弘
出生 了	Xネ F
出生 满	Xネ 骸
出生 人	Xネ H
出生 时	Xネ 
出生 一	Xネ @
出生 于	Xネ _
出生 约	Xネ 
出生 在	Xネ b
出示 的	Xボ 
出示 红	Xボ 
出示 证	Xボ 谍
出世 好	X@ n
出世 时	X@ 
出事地点 奔	XㄆaI b
出事地点 在	XㄆaI b
出事 海	Xㄆ 
出事 是	Xㄆ O
出售 本	X扳 セ
出售 的	X扳 
出售 等	X扳 单
出售 给	X扳 倒
出售 哈	X扳 
出售 核	X扳 
出售 和	X扳 M
出售 后	X扳 
出售 假	X扳 安
出售 昆	X扳 
出售 量	X扳 q
出售 了	X扳 F
出售 面	X扳 
出售 苗	X扳 ]
出售 农	X扳 A
出售 千	X扳 d
出售 时	X扳 
出售 苏	X扳 默
出售 也	X扳 ]
出售 一	X扳 @
出售 余	X扳 E
出售 在	X扳 b
出售 这	X扳 o
出题 相	XD 
出头 办	XY 快
出头 的	XY 
出头 来	XY ㄓ
出土 的	Xg 
出土 地	Xg a
出土 对	Xg 癸
出土 了	Xg F
出外 国	X~ 瓣
出外 来	X~ ㄓ
出外 旅	X~ 
出问题 的	X拜D 
出问题 可	X拜D i
出席 阿	Xu 
出席 艾	Xu 
出席 安	Xu w
出席 本	Xu セ
出席 并	Xu }
出席 茶	Xu 
出席 的	Xu 
出席 关	Xu 闽
出席 过	Xu L
出席 将	Xu N
出席 揭	Xu 处
出席 了	Xu F
出席 马	Xu 皑
出席 毛	Xu を
出席 七	Xu C
出席 人	Xu H
出席 首	Xu 
出席 授	Xu 甭
出席 温	Xu 放
出席 我	Xu и
出席 亚	Xu ㄈ
出席 一	Xu @
出席 由	Xu パ
出席 有	Xu Τ
出席 于	Xu _
出席 在	Xu b
出席 这	Xu o
出席 政	Xu F
出席 中	Xu い
出现 百	X{ κ
出现 备	X{ 称
出现 冰	X{ B
出现 虫	X{ 
出现 此	X{ 
出现 从	X{ q
出现 大	X{ j
出现 的	X{ 
出现 对	X{ 癸
出现 多	X{ h
出现 二	X{ G
出现 复	X{ _
出现 柑	X{ a
出现 更	X{ 
出现 关	X{ 闽
出现 过	X{ L
出现 好	X{ n
出现 和	X{ M
出现 后	X{ 
出现 回	X{ ^
出现 火	X{ 
出现 极	X{ 伐
出现 几	X{ X
出现 较	X{ 耕
出现 近	X{ 
出现 康	X{ d
出现 可	X{ i
出现 老	X{ ρ
出现 雷	X{ p
出现 良	X{ }
出现 两	X{ ㄢ
出现 了	X{ F
出现 旅	X{ 
出现 乱	X{ 睹
出现 卖	X{ 芥
出现 猛	X{ r
出现 民	X{ チ
出现 那	X{ ê
出现 起	X{ _
出现 热	X{ 荐
出现 三	X{ T
出现 上	X{ W
出现 时	X{ 
出现 什	X{ ぐ
出现 是	X{ O
出现 适	X{ A
出现 数	X{ 计
出现 四	X{ |
出现 危	X{ M
出现 险	X{ I
出现 小	X{ p
出现 效	X{ 
出现 新	X{ s
出现 学	X{ 厩
出现 一	X{ @
出现 阴	X{ 潮
出现 盈	X{ 
出现 由	X{ パ
出现 油	X{ o
出现 有	X{ Τ
出现 于	X{ _
出现 鱼	X{ 辰
出现 雨	X{ B
出现 与	X{ P
出现 月	X{ る
出现 在	X{ b
出现 这	X{ o
出现 争	X{ 
出现 中	X{ い
出现 重	X{ 
出现 渍	X{ {
出血 病	X f
出血 倒	X 
出血 和	X M
出血 患	X w
出血 量	X q
出血 少	X ぶ
出血 症	X g
出诊 的	XE 
出诊 费	XE O
出阵 阵	X} }
出众 的	X渤 
出主意 想	XDN Q
出资购买 以	X戈潦R H
出资购买 这	X戈潦R o
出自 藏	X 旅
出自 己	X v
出自 我	X и
出自 一	X @
出自 已	X w
出走 到	Xǐ 
出租汽车 及	X波Tó の
出租汽车 日	X波Tó ら
出租汽车 为	X波Tó 
出租 车	X ó
出租 给	X 倒
出租 率	X v
出租 僳	X 圄
出租 小	X p
出 艾	X 
出 爱	X R
出 扒	X ザ
出 白	X フ
出 百	X κ
出 班	X Z
出 半	X b
出 被	X Q
出 笨	X 猜
出 比	X ゑ
出 便	X K
出 冰	X B
出 并	X }
出 勃	X k
出 补	X 干
出 不	X ぃ
出 材	X 
出 参	X 把
出 叉	X e
出 铲	X 藐
出 长	X 
出 厂	X t
出 朝	X 绰
出 车	X ó
出 城	X 
出 成	X Θ
出 乘	X 
出 川	X t
出 传	X 肚
出 纯	X 
出 此	X 
出 从	X q
出 大	X j
出 带	X a
出 单	X 虫
出 党	X 囊
出 岛	X q
出 得	X o
出 的	X 
出 灯	X O
出 等	X 单
出 低	X C
出 点	X I
出 调	X 秸
出 定	X w
出 订	X q
出 冬	X V
出 洞	X }
出 对	X 癸
出 蹲	X 蜜
出 多	X h
出 朵	X Ψ
出 仿	X ラ
出 访	X X
出 飞	X 
出 废	X o
出 粉	X 
出 丰	X 伦
出 高	X 蔼
出 格	X 
出 个	X 
出 各	X U
出 更	X 
出 工	X u
出 供	X ㄑ
出 共	X @
出 关	X 闽
出 光	X 
出 锅	X 羚
出 过	X L
出 好	X n
出 和	X M
出 很	X 
出 狠	X 
出 洪	X x
出 红	X 
出 后	X 
出 化	X て
出 话	X 杠
出 欢	X w
出 缓	X w
出 黄	X 独
出 回	X ^
出 或	X ┪
出 击	X 阑
出 缉	X r
出 吉	X N
出 极	X 伐
出 几	X X
出 既	X J
出 继	X ~
出 坚	X 绊
出 尖	X y
出 简	X 虏
出 减	X 搭
出 将	X N
出 江	X 
出 疆	X 忙
出 交	X ユ
出 角	X à
出 绞	X 当
出 较	X 耕
出 接	X 钡
出 界	X 
出 进	X i
出 近	X 
出 精	X 弘
出 井	X か
出 酒	X s
出 聚	X E
出 具	X ㄣ
出 开	X }
出 刊	X Z
出 抗	X к
出 科	X 
出 壳	X 催
出 可	X i
出 库	X w
出 块	X 遏
出 扩	X X
出 栏	X 逆
出 劳	X 骋
出 老	X ρ
出 良	X }
出 两	X ㄢ
出 量	X q
出 了	X F
出 岭	X 拉
出 另	X t
出 硫	X 哺
出 卢	X c
出 率	X v
出 马	X 皑
出 满	X 骸
出 煤	X 费
出 米	X μ
出 苗	X ]
出 民	X チ
出 明	X 
出 魔	X ]
出 谋	X 垦
出 亩	X a
出 那	X ê
出 男	X k
出 呢	X O
出 能	X 
出 你	X A
出 农	X A
出 女	X k
出 排	X 逼
出 盘	X L
出 圃	X E
出 七	X C
出 其	X ㄤ
出 齐	X 霍
出 起	X _
出 千	X d
出 前	X e
出 墙	X 鲤
出 抢	X m
出 鞘	X T
出 亲	X 克
出 青	X C
出 情	X 薄
出 求	X D
出 圈	X 伴
出 全	X 
出 人	X H
出 任	X ヴ
出 肉	X ψ
出 塞	X 峨
出 三	X T
出 杀	X 炳
出 山	X s
出 上	X W
出 沈	X H
出 省	X 
出 师	X v
出 十	X Q
出 时	X 
出 适	X A
出 手	X も
出 书	X 
出 数	X 计
出 水	X 
出 说	X 弧
出 硕	X 河
出 撕	X 脊
出 四	X |
出 饲	X }
出 所	X ┮
出 他	X L
出 它	X ウ
出 台	X x
出 摊	X u
出 条	X 兵
出 铁	X K
出 铜	X 簧
出 兔	X ㄟ
出 危	X M
出 违	X H
出 为	X 
出 维	X 蝴
出 我	X и
出 无	X L
出 五	X き
出 物	X 
出 息	X 
出 喜	X 尺
出 戏	X 栏
出 细	X 灿
出 下	X U
出 夏	X L
出 险	X I
出 县	X 郡
出 线	X u
出 相	X 
出 祥	X 不
出 向	X V
出 小	X p
出 效	X 
出 新	X s
出 形	X 
出 行	X 
出 许	X \
出 悬	X a
出 岩	X ━
出 阳	X 锭
出 样	X 妓
出 要	X n
出 一	X @
出 印	X L
出 应	X 莱
出 迎	X 
出 用	X ノ
出 优	X u
出 由	X パ
出 油	X o
出 有	X Τ
出 于	X _
出 与	X P
出 语	X y
出 狱	X 夯
出 院	X |
出 约	X 
出 运	X B
出 在	X b
出 渣	X 错
出 展	X i
出 战	X 驹
出 站	X 
出 账	X 姐
出 这	X o
出 征	X ┖
出 之	X ぇ
出 指	X 
出 中	X い
出 专	X M
出 砖	X j
出 资	X 戈
出 最	X 程
出 拚	X ╅
出 殡	X l
除此之外 还	埃工Д~ 临
除非 万	埃D U
除 家	埃 a
除 佩	埃 ㄘ
储备 额	x称 B
储蓄 额	xW B
处方 签	Bよ 帽
处 并	B }
处 发	B o
处 共	B @
处 敬	B q
处 签	B 帽
处 邢	B ǚ
川 并	t }
传染病 发	肚Vf o
传统 布	肚参 ガ
传统 发	肚参 o
传 布	肚 ガ
传 出	肚 X
传 万	肚 U
喘气 病	齿 f
串 成	 Θ
串 串	 
串 村	 
串 到	 
串 的	 
串 调	 秸
串 岗	 ^
串 户	 め
串 换	 传
串 讲	 量
串 了	 F
串 门	 
串 亲	 克
串 深	 `
串 威	 
串 西	 
串 巷	 
串 学	 厩
串 洋	 v
串 友	 ね
串 寨	 闺
闯出 了	卖X F
闯出 危	卖X M
闯出 一	卖X @
创始人 布	承lH ガ
创始人 苏	承lH 默
创造 出	承y X
创造 丰	承y 伦
创作 出	承@ X
创 出	承 X
春风 熏	K 饫
春季 杯	Ku M
春季 丰	Ku 伦
春秋 的	K 
春秋 里	K 
春秋 鲁	K |
春秋 已	K w
春秋 战	K 驹
春笋 杯	K但 M
春 并	K }
椿 树	菹 攫
磁 疗	合 励
辞 杯	勉 M
慈 溪	O 匪
瓷 杯	病 M
词 并	迭 }
此次 苏	功 默
此番 并	沟f }
此时 斗	巩 矮
此 并	 }
次 杯	Ω M
次 采	Ω 蹦
次 出	Ω X
次 发	Ω o
次 丰	Ω 伦
次 格	Ω 
次 共	Ω @
次 家	Ω a
匆忙 出	^Γ X
从此 家	q a
从而 丰	qτ 伦
从来 舍	qㄓ 
从没 出	qS X
从中 共	qい @
从 布	q ガ
从 出	q X
从 丰	q 伦
从 扶	q н
从 格	q 
从 家	q a
从 苏	q 默
丛书 共	O @
粗布 蓝	彩ガ 屡
粗 树	彩 攫
促进 出	Pi X
促进 苏	Pi 默
催泪弹 并	妒\u }
脆 出	 X
村 扁	 
村 并	 }
村 串	 
村 共	 @
村 签	 帽
存款 额	s蹿 B
存 伦	s 
磋商 签	R坝 帽
措施 并	惫I }
达到 布	F ガ
达到 丰	F 伦
达赖喇嘛 从	F苦斥估 q
达赖喇嘛 的	F苦斥估 
达赖喇嘛 访	F苦斥估 X
达赖喇嘛 还	F苦斥估 临
达赖喇嘛 派	F苦斥估 
达赖喇嘛 于	F苦斥估 _
达 杯	F M
达 布	F ガ
达 发	F o
达 伦	F 
达 万	F U
打包 托	ゴ] Λ
打出 更	ゴX 
打出 国	ゴX 瓣
打出 来	ゴX ㄓ
打出 了	ゴX F
打出 日	ゴX ら
打出 数	ゴX 计
打出 新	ゴX s
打出 一	ゴX @
打斗 从	ゴ矮 q
打开 发	ゴ} o
打气 的	ゴ 
打球 出	ゴy X
打拳 的	ゴ 
打拳 者	ゴ 
打算 并	ゴ衡 }
打 发	ゴ o
大臣 布	j ガ
大臣 托	j Λ
大大 丰	jj 伦
大地 布	ja ガ
大地 丰	ja 伦
大多数 采	jh计 蹦
大方 万	jよ U
大丰收 的	j伦Μ 
大丰收 是	j伦Μ O
大丰收 之	j伦Μ ぇ
大丰收 做	j伦Μ 暗
大户 共	jめ @
大会 并	j| }
大会 发	j| o
大会 共	j| @
大会 签	j| 帽
大家 安	ja w
大家 把	ja р
大家 拜	ja 
大家 办	ja 快
大家 帮	ja 腊
大家 报	ja 厨
大家 比	ja ゑ
大家 边	ja 娩
大家 不	ja ぃ
大家 才	ja ~
大家 称	ja 嘿
大家 充	ja R
大家 出	ja X
大家 创	ja 承
大家 打	ja ゴ
大家 当	ja 讽
大家 的	ja 
大家 都	ja 常
大家 对	ja 癸
大家 多	ja h
大家 发	ja o
大家 富	ja I
大家 拱	ja 
大家 过	ja L
大家 哈	ja 
大家 合	ja X
大家 很	ja 
大家 欢	ja w
大家 伙	ja ル
大家 见	ja ǎ
大家 讲	ja 量
大家 就	ja N
大家 砍	ja 
大家 看	ja 
大家 快	ja е
大家 拉	ja ┰
大家 来	ja ㄓ
大家 勒	ja 扒
大家 立	ja ミ
大家 联	ja p
大家 了	ja F
大家 落	ja 辅
大家 买	ja R
大家 们	ja 
大家 能	ja 
大家 你	ja A
大家 弄	ja 
大家 全	ja 
大家 却	ja o
大家 说	ja 弧
大家 送	ja e
大家 算	ja 衡
大家 所	ja ┮
大家 谈	ja 酵
大家 挑	ja D
大家 贴	ja K
大家 听	ja 钮
大家 庭	ja x
大家 同	ja P
大家 围	ja 瞅
大家 问	ja 拜
大家 想	ja Q
大家 向	ja V
大家 心	ja み
大家 选	ja 匡
大家 学	ja 厩
大家 要	ja n
大家 也	ja ]
大家 一	ja @
大家 以	ja H
大家 应	ja 莱
大家 有	ja Τ
大家 越	ja V
大家 再	ja A
大家 在	ja b
大家 怎	ja 
大家 正	ja タ
大家 直	ja 
大家 致	ja P
大家 终	ja 沧
大家 做	ja 暗
大街 万	j刁 U
大力支持 扶	jOや н
大力 发	jO o
大量 采	jq 蹦
大量 丰	jq 伦
大楼 并	j加 }
大楼 共	j加 @
大陆 板	j嘲 O
大气 采	j 蹦
大使 布	jㄏ ガ
大使 佩	jㄏ ㄘ
大使 托	jㄏ Λ
大使 邢	jㄏ ǚ
大西洋 杯	j璎v M
大学生 共	j厩ネ @
大运河 苏	jBe 默
大主教 托	jD毙 Λ
大著 家	j帝 a
大专院校 发	jM| o
大专院校 共	jM| @
大作 出	j@ X
大 板	j O
大 铲	j 藐
大 出	j X
大 堤	j 出
大 额	j B
大 发	j o
大 丰	j 伦
大 秋	j 
大 树	j 攫
歹徒 殊	わ{ 
戴眼镜 的	拦泊描 
戴 格	拦 
戴 家	拦 a
戴 帽	拦 U
带回家 乡	a^a m
带回家 中	a^a い
带头 扶	aY н
带 并	a }
带 出	a X
代表团 出	N砉 X
代表团 共	N砉 @
代表团 莅	N砉 Y
代表 并	N }
代表 出	N X
代表 发	N o
代表 共	N @
代理主席 拉	NzDu ┰
代 痴	N 扶
代 发	N o
代 签	N 帽
贷款 额	U蹿 B
贷款 扶	U蹿 н
贷款 共	U蹿 @
贷 斗	U 矮
贷 扶	U н
待发 的	莸o 
逮捕 昂	e 
担任 堤	踞ヴ 出
丹青 妙	うC М
单方面 把	虫よ р
单方面 从	虫よ q
单方面 的	虫よ 
单方面 地	虫よ a
单位 共	虫 @
单位 签	虫 帽
单位 树	虫 攫
单 板	虫 O
单 家	虫 a
单 弦	虫 ┒
但是 并	O }
但是 布	O ガ
但 并	 }
但 布	 ガ
但 出	 X
但 格	 
但 共	 @
但 家	 a
但 苏	 默
弹 出	u X
蛋白 并	Jフ }
当初 签	讽 帽
当地 采	讽a 蹦
当即 发	讽Y o
当家作主 的	讽a@D 
当家作主 了	讽a@D F
当家 人	讽a H
当家 是	讽a O
当家 作	讽a @
当局 并	讽Ы }
当局 共	讽Ы @
当年 成	讽~ Θ
当年 吃	讽~ Y
当年 出	讽~ X
当年 从	讽~ q
当年 大	讽~ j
当年 党	讽~ 囊
当年 的	讽~ 
当年 对	讽~ 癸
当年 多	讽~ h
当年 樊	讽~ 荚
当年 贺	讽~ P
当年 红	讽~ 
当年 还	讽~ 临
当年 获	讽~ 莉
当年 冀	讽~ 粳
当年 鉴	讽~ 懦
当年 建	讽~ 
当年 仅	讽~ 度
当年 就	讽~ N
当年 雷	讽~ p
当年 李	讽~ 
当年 立	讽~ ミ
当年 两	讽~ ㄢ
当年 洛	讽~ 
当年 茅	讽~ T
当年 毛	讽~ を
当年 没	讽~ S
当年 梦	讽~ 冠
当年 那	讽~ ê
当年 欧	讽~ 稼
当年 配	讽~ t
当年 起	讽~ _
当年 黔	讽~ r
当年 琼	讽~ 茫
当年 穷	讽~ a
当年 全	讽~ 
当年 任	讽~ ヴ
当年 陕	讽~ 阿
当年 上	讽~ W
当年 数	讽~ 计
当年 他	讽~ L
当年 投	讽~ щ
当年 万	讽~ U
当年 为	讽~ 
当年 我	讽~ и
当年 想	讽~ Q
当年 新	讽~ s
当年 要	讽~ n
当年 也	讽~ ]
当年 已	讽~ w
当年 应	讽~ 莱
当年 有	讽~ Τ
当年 在	讽~ b
当年 脏	讽~ 纽
当年 曾	讽~ 纯
当年 只	讽~ u
当年 种	讽~ 贺
当年 竹	讽~ λ
当年 总	讽~ `
当前 扶	讽e н
党员 发	囊 o
党员 家	囊 a
党 共	囊 @
荡 秋	亢 
档 布	郎 ガ
倒不如 说	摔＆p 弧
倒塌 后	硕 
到场 外	斐 ~
到家 的	飚a 
到家 后	飚a 
到家 啦	飚a 罢
到家 里	飚a 
到家 了	飚a F
到家 用	飚a ノ
到了 家	欷F a
到 昂	 
到 铲	 藐
到 出	 X
到 发	 o
到 丰	 伦
到 格	 
到 敬	 q
到 秋	 
到 苏	 默
道路 并	D隔 }
道 并	D }
道 出	D X
道 格	D 
道 共	D @
道 默	D q
道 树	D 攫
德国 共	w瓣 @
德国 苏	w瓣 默
德 并	w }
德 布	w ガ
德 采	w 蹦
德 发	w o
德 家	w a
德 伦	w 
德 签	w 帽
德 树	w 攫
德 苏	w 默
得分 并	oだ }
得 出	o X
得 丰	o 伦
得 万	o U
的 矮	 G
的 昂	 
的 板	 O
的 杯	 M
的 背	 I
的 并	 }
的 卜	 R
的 布	 ガ
的 采	 蹦
的 痴	 扶
的 出	 X
的 串	 
的 堤	 出
的 斗	 矮
的 缎	 v
的 额	 B
的 发	 o
的 丰	 伦
的 扶	 н
的 格	 
的 共	 @
的 婚	 B
的 迹	 格
的 家	 a
的 坚	 绊
的 疗	 励
的 漫	 憨
的 默	 q
的 佩	 ㄘ
的 扑	 汲
的 签	 帽
的 殊	 
的 树	 攫
的 苏	 默
的 涂	 额
的 托	 Λ
的 万	 U
的 熏	 饫
的 珀	 
登出 后	nX 
登记 焊	nO k
登 布	n ガ
登 坚	n 绊
等 矮	单 G
等 额	单 B
等 发	单 o
等 丰	单 伦
等 共	单 @
等 家	单 a
等 树	单 攫
等 万	单 U
邓 布	H ガ
邓 家	H a
堤 安	出 w
堤 坝	出 膨
堤 大	出 j
堤 的	出 
堤 都	出 常
堤 堆	出 帮
堤 防	出 
堤 合	出 X
堤 记	出 O
堤 建	出 
堤 林	出 L
堤 上	出 W
堤 外	出 ~
堤 下	出 U
堤 烟	出 废
堤 堰	出 橱
堤 在	出 b
堤 筑	出 诞
堤 纵	出 a
低 矮	C G
低 出	C X
低 发	C o
迪 出	} X
迪 格	} 
狄 格	f 
翟 树	C 攫
翟 万	C U
抵 苏	╄ 默
底板 上	┏O W
底 格	┏ 
底 共	┏ @
地板 后	aO 
地板 上	aO W
地板 拖	aO ╈
地点 共	aI @
地方政府 签	aよF┎ 帽
地方政府 舍	aよF┎ 
地区 昂	a跋 
地区 并	a跋 }
地区 布	a跋 ガ
地区 发	a跋 o
地区 扶	a跋 н
地区 共	a跋 @
地区 苏	a跋 默
地区 托	a跋 Λ
地区 万	a跋 U
地位 并	a }
地下 出	aU X
地震 共	a_ @
地质学家 的	a借厩a 
地质 板	a借 O
地 背	a I
地 铲	a 藐
地 出	a X
地 串	a 
地 发	a o
地 共	a @
地 汲	a V
地 家	a a
地 敬	a q
地 剃	a c
地 托	a Λ
蒂 昂	甫 
蒂 并	甫 }
蒂 格	甫 
第二 杯	材G M
第二 家	材G a
第三 杯	材T M
第三 家	材T a
第一 杯	材@ M
第一 采	材@ 蹦
第一 家	材@ a
弟子 邢	踏l ǚ
递减 采	患搭 蹦
递 出	患 X
缔结 苏	l挡 默
掂 出	i X
点 出	I X
点 共	I @
点 焊	I k
垫 布	乖 ガ
电焊 工	qk u
电话铃 就	q杠a N
电话铃 那	q杠a ê
电话铃 声	q杠a n
电话铃 响	q杠a T
电缆 布	ql ガ
电影艺术 家	qv美N a
电影艺术 节	qv美N `
电子显示器 上	ql陪ボ竟 W
电子显微镜 下	ql陪L描 U
电 并	q }
电 铲	q 藐
电 万	q U
店 发	┍ o
惦记 家	}O a
雕刻版 本	Jㄨ セ
雕刻 的	Jㄨ 
雕刻 后	Jㄨ 
雕刻 用	Jㄨ ノ
雕刻 著	Jㄨ 帝
雕塑 成	J鹅 Θ
雕塑 等	J鹅 单
雕塑 家	J鹅 a
雕塑 类	J鹅 摸
雕塑 亭	J鹅 F
雕塑 下	J鹅 U
雕塑 要	J鹅 n
雕像 高	J钩 蔼
雕像 由	J钩 パ
雕像 与	J钩 P
雕像 在	J钩 b
雕 大	J j
雕 给	J 倒
雕 会	J |
雕 梁	J 辩
雕 在	J b
雕 凿	J w
掉 家	奔 a
吊桶 并	Q表 }
吊 杯	Q M
调查 采	秸d 蹦
调查 秋	秸d 
调剂 丰	秸警 伦
调配 出	秸t X
调皮 出	秸ブ X
调整 布	秸俱 ガ
调整 出	秸俱 X
调 出	秸 X
叠 出	| X
丁 杯	B M
丁 格	B 
顶峰 的	郴p 
顶风 抗	郴 к
顶风 冒	郴 _
顶风 雪	郴 撤
顶风 作	郴 @
定额 的	wB 
定额 和	wB M
定额 上	wB W
定额 委	wB e
定额 装	wB 杆
定价 格	w基 
定名 次	wW Ω
定名 黔	wW r
定名 为	wW 
定 并	w }
定 出	w X
订 采	q 蹦
订 出	q X
东部 共	F场 @
东方 家	Fよ a
东家 串	Fa 
东京 共	Fㄊ @
东南 万	Fn U
东 布	F ガ
东 发	F o
东 丰	F 伦
东 托	F Λ
冬 共	V @
董 家	赋 a
董 树	赋 攫
动乱 并	笆睹 }
动手术 的	笆もN 
动手术 刚	笆もN 
动手术 缺	笆もN 
动物学 家	笆厩 a
动员 万	笆 U
动 并	笆 }
栋 家	瓷 a
斗殴 成	矮嫁 Θ
斗殴 的	矮嫁 
斗殴 等	矮嫁 单
斗殴 和	矮嫁 M
斗殴 这	矮嫁 o
斗争 常	矮 `
斗争 的	矮 
斗争 等	矮 单
斗争 关	矮 闽
斗争 和	矮 M
斗争 后	矮 
斗争 换	矮 传
斗争 及	矮 の
斗争 几	矮 X
斗争 将	矮 N
斗争 了	矮 F
斗争 却	矮 o
斗争 任	矮 ヴ
斗争 时	矮 
斗争 史	矮 v
斗争 势	矮 墩
斗争 是	矮 O
斗争 说	矮 弧
斗争 所	矮 ┮
斗争 推	矮 崩
斗争 相	矮 
斗争 要	矮 n
斗争 也	矮 ]
斗争 应	矮 莱
斗争 有	矮 Τ
斗争 又	矮 S
斗争 中	矮 い
斗争 走	矮 ǐ
斗智 斗	矮醇 矮
斗 车	矮 ó
斗 吃	矮 Y
斗 持	矮 
斗 的	矮 
斗 地	矮 a
斗 风	矮 
斗 海	矮 
斗 和	矮 M
斗 焕	矮 坟
斗 机	矮 诀
斗 角	矮 à
斗 金	矮 
斗 兰	矮 孽
斗 门	矮 
斗 奇	矮 _
斗 沙	矮 F
斗 士	矮 h
斗 是	矮 O
斗 危	矮 M
斗 雪	矮 撤
斗 艳	矮 A
斗 勇	矮 i
斗 志	矮 в
斗 转	矮 锣
都 铲	常 藐
都 出	常 X
都 扑	常 汲
都 签	常 帽
都 舍	常 
毒打 举	rゴ |
独立国 家	Wミ瓣 a
独立 杯	Wミ M
独树一帜 的	W攫@m 
独特 疗	WS 励
独有 并	WΤ }
独 家	W a
读者 发	弄 o
读 出	弄 X
杜仲 树	ヲ 攫
杜 布	 ガ
杜 家	 a
肚子 背	{l I
度 并	 }
度 出	 X
度 共	 @
渡 扶	寸 н
端 杯	狠 M
短 发	u o
段 并	q }
段 共	q @
段 苏	q 默
缎 带	v a
缎 的	v 
缎 和	v M
缎 料	v 
缎 向	v V
堆 家	帮 a
队长 家	钉 a
队伍 发	钉ヮ o
队友 格	钉ね 
队友 佩	钉ね ㄘ
队员 布	钉 ガ
队员 共	钉 @
队 采	钉 蹦
队 出	钉 X
队 发	钉 o
队 共	钉 @
对策 并	癸郸 }
对方 婉	癸よ 胞
对分 出	癸だ X
对话 并	癸杠 }
对开 发	癸} o
对手 逼	癸も G
对外 签	癸~ 帽
对象 出	癸H X
对象 共	癸H @
对 昂	癸 
对 并	癸 }
对 布	癸 ガ
对 采	癸 蹦
对 出	癸 X
对 丰	癸 伦
对 扶	癸 н
对 格	癸 
对 家	癸 a
对 苏	癸 默
对 托	癸 Λ
对 万	癸 U
墩 杯	[ M
敦促 北	窗P _
敦促 比	窗P ゑ
敦促 布	窗P ガ
敦促 戈	窗P む
敦促 和	窗P M
敦促 洪	窗P x
敦促 利	窗P Q
敦促 两	窗P ㄢ
敦促 美	窗P 
敦促 南	窗P n
敦促 其	窗P ㄤ
敦促 撒	窗P 蓟
敦促 沙	窗P F
敦促 他	窗P L
敦促 它	窗P ウ
敦促 乍	窗P E
顿 杯	y M
多少 殊	hぶ 
多数人 家	h计H a
多 并	h }
多 布	h ガ
多 采	h 蹦
多 出	h X
多 串	h 
多 发	h o
多 格	h 
多 家	h a
多 树	h 攫
多 万	h U
夺取 丰	管 伦
夺 丰	管 伦
额头 和	BY M
额头 上	BY W
额 把	B р
额 百	B κ
额 包	B ]
额 比	B ゑ
额 并	B }
额 补	B 干
额 不	B ぃ
额 才	B ~
额 超	B W
额 呈	B e
额 创	B 承
额 从	B q
额 达	B F
额 大	B j
额 的	B 
额 定	B w
额 都	B 常
额 度	B 
额 尔	B 焊
额 翻	B 陆
额 高	B 蔼
额 共	B @
额 挂	B 本
额 好	B n
额 和	B M
额 很	B 
额 回	B ^
额 技	B м
额 计	B p
额 将	B N
额 较	B 耕
额 仅	B 度
额 近	B 
额 经	B g
额 就	B N
额 居	B ~
额 剧	B @
额 均	B А
额 砍	B 
额 看	B 
额 可	B i
额 立	B ミ
额 猛	B r
额 木	B れ
额 却	B o
额 人	B H
额 仍	B ご
额 如	B p
额 锐	B U
额 上	B W
额 是	B O
额 收	B Μ
额 同	B P
额 为	B 
额 也	B ]
额 已	B w
额 以	B H
额 用	B ノ
额 由	B パ
额 有	B Τ
额 又	B S
额 逾	B O
额 与	B P
额 约	B 
额 在	B b
额 则	B h
额 增	B W
额 占	B 
额 之	B ぇ
额 只	B u
额 制	B 
额 中	B い
额 逐	B v
额 转	B 锣
额 最	B 程
恶臭 逼	c G
鄂 伦	k 
恩格尔 特	Ξ婧 S
恩 布	 ガ
恩 格	 
恩 苏	 默
恩 万	 U
而且 出	τB X
而 昂	τ 
而 并	τ }
而 出	τ X
而 共	τ @
而 漫	τ 憨
而 苏	τ 默
儿子 家	ㄠl a
儿子 苏	ㄠl 默
耳 布	φ ガ
尔格 尔	焊 焊
尔格 拉	焊 ┰
尔格 莱	焊 弟
尔格 娃	焊 
尔 并	焊 }
尔 布	焊 ガ
尔 采	焊 蹦
尔 出	焊 X
尔 共	焊 @
尔 家	焊 a
尔 默	焊 q
尔 佩	焊 ㄘ
尔 苏	焊 默
尔 托	焊 Λ
尔 万	焊 U
二 采	G 蹦
发白 发	oフ o
发白 了	oフ F
发表声明 对	o砹n 癸
发表声明 和	o砹n M
发表声明 后	o砹n 
发表声明 呼	o砹n I
发表声明 或	o砹n ┪
发表声明 说	o砹n 弧
发表宣言 或	o慝浓 ┪
发表演说 时	o砗t弧 
发表 的	o 
发表 点	o I
发表 对	o 癸
发表 反	o は
发表 该	o 赣
发表 高	o 蔼
发表 告	o i
发表 关	o 闽
发表 过	o L
发表 和	o M
发表 后	o 
发表 呼	o I
发表 或	o ┪
发表 讲	o 量
发表 了	o F
发表 什	o ぐ
发表 他	o L
发表 谈	o 酵
发表 题	o D
发表 同	o P
发表 文	o ゅ
发表 一	o @
发表 于	o _
发表 在	o b
发表 这	o o
发表 之	o ぇ
发表 著	o 帝
发表 专	o M
发布 产	oガ 玻
发布 的	oガ 
发布 各	oガ U
发布 关	oガ 闽
发布 寒	oガ H
发布 会	oガ |
发布 了	oガ F
发布 一	oガ @
发布 这	oガ o
发布 之	oガ ぇ
发颤 了	o鸥 F
发车 皮	oó ブ
发愁 的	oT 
发愁 了	oT F
发出 的	oX 
发出 访	oX X
发出 高	oX 蔼
发出 关	oX 闽
发出 国	oX 瓣
发出 过	oX L
发出 红	oX 
发出 后	oX 
发出 呼	oX I
发出 欢	oX w
发出 几	oX X
发出 近	oX 
发出 咯	oX 
发出 来	oX ㄓ
发出 了	oX F
发出 微	oX L
发出 吓	oX ~
发出 向	oX V
发出 一	oX @
发出 这	oX o
发出 之	oX ぇ
发达 的	oF 
发达 而	oF τ
发达 国	oF 瓣
发达 省	oF 
发达 与	oF P
发电厂 的	oqt 
发电厂 二	oqt G
发电厂 和	oqt M
发电厂 可	oqt i
发电厂 来	oqt ㄓ
发电厂 所	oqt ┮
发电厂 肖	oqt v
发电机 不	oq诀 ぃ
发电机 的	oq诀 
发电机 等	oq诀 单
发电机 和	oq诀 M
发电机 三	oq诀 T
发电机 组	oq诀 舱
发电 按	oq 
发电 车	oq ó
发电 的	oq 
发电 耗	oq 
发电 或	oq ┪
发电 既	oq J
发电 近	oq 
发电 量	oq q
发电 煤	oq 费
发电 外	oq ~
发电 用	oq ノ
发电 站	oq 
发电 装	oq 杆
发动机 被	o笆诀 Q
发动机 不	o笆诀 ぃ
发动机 厂	o笆诀 t
发动机 的	o笆诀 
发动机 顶	o笆诀 郴
发动机 分	o笆诀 だ
发动机 及	o笆诀 の
发动机 声	o笆诀 n
发动机 为	o笆诀 
发动机 油	o笆诀 o
发动机 制	o笆诀 
发动 把	o笆 р
发动 本	o笆 セ
发动 的	o笆 
发动 第	o笆 材
发动 干	o笆 F
发动 更	o笆 
发动 和	o笆 M
发动 快	o笆 е
发动 了	o笆 F
发动 林	o笆 L
发动 千	o笆 d
发动 强	o笆 j
发动 全	o笆 
发动 三	o笆 T
发动 师	o笆 v
发动 县	o笆 郡
发动 一	o笆 @
发动 职	o笆 戮
发放 春	o K
发放 到	o 
发放 的	o 
发放 扶	o н
发放 给	o 倒
发放 和	o M
发放 良	o }
发放 量	o q
发放 了	o F
发放 蒙	o X
发放 农	o A
发放 上	o W
发放 同	o P
发放 信	o H
发放 一	o @
发放 这	o o
发放 支	o や
发放 只	o u
发疯 似	o浩 
发高烧 也	o蔼N ]
发稿 时	oZ 
发给 创	o倒 承
发给 的	o倒 
发给 各	o倒 U
发给 患	o倒 w
发给 了	o倒 F
发给 每	o倒 C
发给 他	o倒 L
发给 我	o倒 и
发给 无	o倒 L
发给 这	o倒 o
发给 职	o倒 戮
发给 中	o倒 い
发工资 和	ou戈 M
发光 的	o 
发还 给	o临 倒
发挥作用 的	o揣@ノ 
发挥作用 是	o揣@ノ O
发挥 鞍	o揣 b
发挥 百	o揣 κ
发挥 保	o揣 O
发挥 本	o揣 セ
发挥 出	o揣 X
发挥 处	o揣 B
发挥 大	o揣 j
发挥 党	o揣 囊
发挥 得	o揣 o
发挥 的	o揣 
发挥 顶	o揣 郴
发挥 二	o揣 G
发挥 妇	o揣 包
发挥 各	o揣 U
发挥 更	o揣 
发挥 工	o揣 u
发挥 过	o揣 L
发挥 海	o揣 
发挥 好	o揣 n
发挥 和	o揣 M
发挥 很	o揣 
发挥 架	o揣 [
发挥 坚	o揣 绊
发挥 减	o揣 搭
发挥 较	o揣 耕
发挥 节	o揣 `
发挥 九	o揣 E
发挥 举	o揣 |
发挥 军	o揣 x
发挥 科	o揣 
发挥 联	o揣 p
发挥 两	o揣 ㄢ
发挥 了	o揣 F
发挥 面	o揣 
发挥 民	o揣 チ
发挥 模	o揣 家
发挥 农	o揣 A
发挥 女	o揣 k
发挥 期	o揣 戳
发挥 其	o揣 ㄤ
发挥 桥	o揣 爵
发挥 全	o揣 
发挥 人	o揣 H
发挥 他	o揣 L
发挥 它	o揣 ウ
发挥 体	o揣 砰
发挥 万	o揣 U
发挥 我	o揣 и
发挥 无	o揣 L
发挥 乡	o揣 m
发挥 效	o揣 
发挥 新	o揣 s
发挥 学	o揣 厩
发挥 也	o揣 ]
发挥 应	o揣 莱
发挥 影	o揣 v
发挥 有	o揣 Τ
发挥 余	o揣 E
发挥 在	o揣 b
发挥 这	o揣 o
发挥 政	o揣 F
发挥 证	o揣 谍
发挥 职	o揣 戮
发挥 主	o揣 D
发挥 著	o揣 帝
发回 的	o^ 
发酵 的	o幻 
发酵 而	o幻 τ
发酵 后	o幻 
发酵 液	o幻 G
发掘 和	o备 M
发掘 迹	o备 格
发掘 了	o备 F
发掘 微	o备 L
发掘 遗	o备 框
发牢骚 多	oc奶 h
发明家 陈	oa 朝
发明家 的	oa 
发明者 是	o O
发明者 向	o V
发明 不	o ぃ
发明 成	o Θ
发明 的	o 
发明 二	o G
发明 奖	o 贱
发明 浇	o 煎
发明 可	o i
发明 了	o F
发明 能	o 
发明 人	o H
发明 外	o ~
发明 新	o s
发明 一	o @
发明 用	o ノ
发明 与	o P
发明 在	o b
发明 这	o o
发难 于	o螟 _
发票 或	o布 ┪
发票 让	o布 琵
发起人 多	o_H h
发起人 和	o_H M
发起人 在	o_H b
发起 并	o_ }
发起 愁	o_ T
发起 创	o_ 承
发起 的	o_ 
发起 搞	o_ d
发起 和	o_ M
发起 举	o_ |
发起 开	o_ }
发起 快	o_ е
发起 了	o_ F
发起 下	o_ U
发起 言	o_ ē
发起 一	o_ @
发起 于	o_ _
发起 职	o_ 戮
发起 主	o_ D
发热 量	o荐 q
发烧 到	oN 
发烧 等	oN 单
发烧 了	oN F
发射机 房	og诀 ┬
发射器 被	og竟 Q
发射器 和	og竟 M
发射塔 是	og娥 O
发射塔 外	og娥 ~
发射台 和	ogx M
发射装置 或	og杆m ┪
发射 到	og 
发射 的	og 
发射 航	og 
发射 后	og 
发射 极	og 伐
发射 架	og [
发射 了	og F
发射 前	og e
发射 是	og O
发射 数	og 计
发射 一	og @
发射 原	og 
发声 钟	on 牧
发生炉煤气 由	oネl费 パ
发生炉煤气 作	oネl费 @
发生 暴	oネ 忌
发生 扯	oネ ц
发生 冲	oネ R
发生 大	oネ j
发生 当	oネ 讽
发生 的	oネ 
发生 动	oネ 笆
发生 多	oネ h
发生 反	oネ は
发生 复	oネ _
发生 更	oネ 
发生 过	oネ L
发生 核	oネ 
发生 和	oネ M
发生 很	oネ 
发生 哄	oネ 
发生 洪	oネ x
发生 后	oネ 
发生 哗	oネ M
发生 毁	oネ 反
发生 火	oネ 
发生 急	oネ 
发生 较	oネ 耕
发生 纠	oネ 
发生 可	oネ i
发生 烂	oネ 年
发生 里	oネ 
发生 两	oネ ㄢ
发生 了	oネ F
发生 裂	oネ 吊
发生 炉	oネ l
发生 路	oネ 隔
发生 录	oネ 魁
发生 率	oネ v
发生 乱	oネ 睹
发生 某	oネ Y
发生 哪	oネ 
发生 那	oネ ê
发生 器	oネ 竟
发生 前	oネ e
发生 浅	oネ L
发生 深	oネ `
发生 失	oネ ア
发生 时	oネ 
发生 什	oネ ぐ
发生 鼠	oネ 公
发生 数	oネ 计
发生 谁	oネ 街
发生 塌	oネ 厄
发生 太	oネ び
发生 跳	oネ 铬
发生 危	oネ M
发生 违	oネ H
发生 下	oネ U
发生 新	oネ s
发生 一	oネ @
发生 伊	oネ レ
发生 因	oネ ]
发生 于	oネ _
发生 余	oネ E
发生 灾	oネ a
发生 在	oネ b
发生 早	oネ Ν
发生 这	oネ o
发生 之	oネ ぇ
发生 质	oネ 借
发生 主	oネ D
发生 著	oネ 帝
发生 转	oネ 锣
发生 总	oネ `
发誓 说	o} 弧
发誓 要	o} n
发售 的	o扳 
发售 和	o扳 M
发送 到	oe 
发送 量	oe q
发送 直	oe 
发往 外	o┕ ~
发文 的	oゅ 
发文 件	oゅ ン
发下 来	oU ㄓ
发下 去	oU h
发现 癌	o{ 砾
发现 矮	o{ G
发现 艾	o{ 
发现 包	o{ ]
发现 被	o{ Q
发现 彼	o{ ┘
发现 病	o{ f
发现 并	o{ }
发现 不	o{ ぃ
发现 藏	o{ 旅
发现 曹	o{ 变
发现 此	o{ 
发现 大	o{ j
发现 的	o{ 
发现 第	o{ 材
发现 独	o{ W
发现 堵	o{ 棒
发现 杜	o{ 
发现 短	o{ u
发现 对	o{ 癸
发现 丰	o{ 伦
发现 干	o{ F
发现 搞	o{ d
发现 更	o{ 
发现 古	o{ j
发现 固	o{ T
发现 过	o{ L
发现 含	o{ t
发现 和	o{ M
发现 很	o{ 
发现 后	o{ 
发现 华	o{ 地
发现 还	o{ 临
发现 患	o{ w
发现 火	o{ 
发现 或	o{ ┪
发现 佳	o{ ㄎ
发现 将	o{ N
发现 近	o{ 
发现 可	o{ i
发现 来	o{ ㄓ
发现 兰	o{ 孽
发现 李	o{ 
发现 里	o{ 
发现 两	o{ ㄢ
发现 了	o{ F
发现 漏	o{ |
发现 率	o{ v
发现 茅	o{ T
发现 某	o{ Y
发现 那	o{ ê
发现 能	o{ 
发现 其	o{ ㄤ
发现 千	o{ d
发现 确	o{ T
发现 三	o{ T
发现 商	o{ 坝
发现 上	o{ W
发现 少	o{ ぶ
发现 时	o{ 
发现 是	o{ O
发现 市	o{ カ
发现 属	o{ 妮
发现 水	o{ 
发现 他	o{ L
发现 它	o{ ウ
发现 她	o{ o
发现 太	o{ び
发现 躺	o{ 仅
发现 同	o{ P
发现 偷	o{ 敖
发现 脱	o{ 叉
发现 为	o{ 
发现 我	o{ и
发现 武	o{ Z
发现 西	o{ 
发现 箱	o{ c
发现 新	o{ s
发现 亚	o{ ㄈ
发现 扬	o{ 喘
发现 要	o{ n
发现 一	o{ @
发现 疫	o{ 
发现 隐	o{ 留
发现 由	o{ パ
发现 有	o{ Τ
发现 于	o{ _
发现 与	o{ P
发现 在	o{ b
发现 张	o{ i
发现 这	o{ o
发现 珍	o{ 
发现 正	o{ タ
发现 职	o{ 戮
发现 致	o{ P
发现 最	o{ 程
发现 罪	o{ o
发现 坐	o{ Г
发祥地 之	o不a ぇ
发笑 著	o 帝
发信 函	oH ㄧ
发行部 门	o娉 
发行债券 等	o娑浓 单
发行债券 都	o娑浓 常
发行债券 将	o娑浓 N
发行 到	o 
发行 的	o 
发行 额	o B
发行 过	o L
发行 和	o M
发行 局	o Ы
发行 量	o q
发行 了	o F
发行 渠	o 措
发行 三	o T
发行 时	o 
发行 式	o Α
发行 是	o O
发行 数	o 计
发行 万	o U
发行 新	o s
发行 业	o ~
发行 有	o Τ
发行 于	o _
发行 这	o o
发行 总	o `
发芽 和	o M
发芽 后	o 
发芽 了	o F
发言权 的	oēv 
发言权 就	oēv N
发言人 阿	oēH 
发言人 鲍	oēH j
发言人 贝	oēH ī
发言人 比	oēH ゑ
发言人 波	oēH i
发言人 布	oēH ガ
发言人 称	oēH 嘿
发言人 的	oēH 
发言人 东	oēH F
发言人 都	oēH 常
发言人 段	oēH q
发言人 对	oēH 癸
发言人 多	oēH h
发言人 菲	oēH 滇
发言人 格	oēH 
发言人 哈	oēH 
发言人 和	oēH M
发言人 胡	oēH J
发言人 还	oēH 临
发言人 霍	oēH N
发言人 杰	oēH 城
发言人 就	oēH N
发言人 拉	oēH ┰
发言人 李	oēH 
发言人 莉	oēH 产
发言人 刘	oēH B
发言人 卢	oēH c
发言人 罗	oēH 霉
发言人 马	oēH 皑
发言人 尼	oēH ェ
发言人 涅	oēH I
发言人 诺	oēH 空
发言人 佩	oēH ㄘ
发言人 评	oēH 蝶
发言人 朴	oēH Φ
发言人 丘	oēH C
发言人 舍	oēH 
发言人 是	oēH O
发言人 说	oēH 弧
发言人 松	oēH P
发言人 颂	oēH |
发言人 苏	oēH 默
发言人 索	oēH 
发言人 塔	oēH 娥
发言人 谈	oēH 酵
发言人 威	oēH 
发言人 韦	oēH 
发言人 吴	oēH d
发言人 姚	oēH 
发言人 也	oēH ]
发言人 伊	oēH レ
发言人 已	oēH w
发言人 尤	oēH ぷ
发言人 在	oēH b
发言人 则	oēH h
发言人 章	oēH 彻
发言人 朱	oēH Χ
发炎 进	o i
发扬光大 的	o喘j 
发扬光大 雷	o喘j p
发音 和	o M
发育不良 的	o|ぃ} 
发育不全 症	o|ぃ g
发育 成	o| Θ
发育 的	o| 
发育 都	o| 常
发育 和	o| M
发育 监	o| 菏
发育 靠	o| a
发育 良	o| }
发育 慢	o| C
发源地 抚	o方a 季
发源地 南	o方a n
发源地 应	o方a 莱
发源 于	o方 _
发展 阿	oi 
发展 艾	oi 
发展 奥	oi 而
发展 比	oi ゑ
发展 必	oi ゲ
发展 边	oi 娩
发展 并	oi }
发展 不	oi ぃ
发展 部	oi 场
发展 才	oi ~
发展 采	oi 蹦
发展 藏	oi 旅
发展 草	oi 
发展 产	oi 玻
发展 朝	oi 绰
发展 成	oi Θ
发展 持	oi 
发展 出	oi X
发展 处	oi B
发展 创	oi 承
发展 从	oi q
发展 促	oi P
发展 村	oi 
发展 打	oi ゴ
发展 大	oi j
发展 但	oi 
发展 党	oi 囊
发展 到	oi 
发展 得	oi o
发展 的	oi 
发展 等	oi 单
发展 低	oi C
发展 地	oi a
发展 电	oi q
发展 订	oi q
发展 都	oi 常
发展 对	oi 癸
发展 多	oi h
发展 而	oi τ
发展 法	oi k
发展 范	oi S
发展 方	oi よ
发展 防	oi 
发展 放	oi 
发展 高	oi 蔼
发展 各	oi U
发展 给	oi 倒
发展 更	oi 
发展 工	oi u
发展 构	oi c
发展 关	oi 闽
发展 郭	oi 尝
发展 国	oi 瓣
发展 过	oi L
发展 海	oi 
发展 航	oi 
发展 和	oi M
发展 很	oi 
发展 互	oi が
发展 还	oi 临
发展 惠	oi f
发展 或	oi ┪
发展 机	oi 诀
发展 积	oi n
发展 极	oi 伐
发展 及	oi の
发展 建	oi 
发展 将	oi N
发展 较	oi 耕
发展 节	oi `
发展 进	oi i
发展 经	oi g
发展 就	oi N
发展 局	oi Ы
发展 看	oi 
发展 烤	oi N
发展 可	oi i
发展 垦	oi 玖
发展 跨	oi 阁
发展 快	oi е
发展 框	oi 
发展 来	oi ㄓ
发展 蓝	oi 屡
发展 立	oi ミ
发展 联	oi p
发展 粮	oi 鲁
发展 良	oi }
发展 两	oi ㄢ
发展 了	oi F
发展 林	oi L
发展 陇	oi 明
发展 卢	oi c
发展 鲁	oi |
发展 旅	oi 
发展 罗	oi 霉
发展 马	oi 皑
发展 煤	oi 费
发展 美	oi 
发展 蒙	oi X
发展 盟	oi 幅
发展 棉	oi 粗
发展 民	oi チ
发展 名	oi W
发展 睦	oi 伏
发展 牧	oi 
发展 奶	oi イ
发展 能	oi 
发展 年	oi ~
发展 农	oi A
发展 品	oi ~
发展 其	oi ㄤ
发展 起	oi _
发展 轻	oi 淮
发展 权	oi v
发展 全	oi 
发展 仍	oi ご
发展 日	oi ら
发展 若	oi Y
发展 弱	oi z
发展 商	oi 坝
发展 上	oi W
发展 尚	oi |
发展 设	oi ]
发展 时	oi 
发展 什	oi ぐ
发展 史	oi v
发展 使	oi ㄏ
发展 势	oi 墩
发展 是	oi O
发展 受	oi 
发展 署	oi p
发展 双	oi 蛮
发展 水	oi 
发展 斯	oi 吹
发展 送	oi e
发展 苏	oi 默
发展 速	oi t
发展 虽	oi 瘤
发展 所	oi ┮
发展 它	oi ウ
发展 太	oi び
发展 态	oi A
发展 特	oi S
发展 提	oi 矗
发展 同	oi P
发展 图	oi 瓜
发展 土	oi g
发展 外	oi ~
发展 为	oi 
发展 我	oi и
发展 乌	oi Q
发展 西	oi 
发展 下	oi U
发展 相	oi 
发展 协	oi 
发展 新	oi s
发展 信	oi H
发展 型	oi 
发展 匈	oi I
发展 序	oi 
发展 盐	oi Q
发展 杨	oi 法
发展 养	oi i
发展 要	oi n
发展 也	oi ]
发展 一	oi @
发展 已	oi w
发展 以	oi H
发展 印	oi L
发展 应	oi 莱
发展 营	oi 犁
发展 用	oi ノ
发展 优	oi u
发展 尤	oi ぷ
发展 有	oi Τ
发展 又	oi S
发展 与	oi P
发展 原	oi 
发展 远	oi 环
发展 在	oi b
发展 这	oi o
发展 正	oi タ
发展 之	oi ぇ
发展 职	oi 戮
发展 至	oi 
发展 滞	oi 孩
发展 中	oi い
发展 种	oi 贺
发展 主	oi D
发展 著	oi 帝
发展 专	oi M
发展 转	oi 锣
发展 总	oi `
发展 走	oi ǐ
发展 最	oi 程
发展 做	oi 暗
发展 作	oi @
发展 闵	oi {
发展 斐	oi 创
发作 而	o@ τ
发作 住	o@ 
发 案	o 
发 把	o р
发 百	o κ
发 保	o O
发 病	o f
发 补	o 干
发 不	o ぃ
发 苍	o a
发 臭	o 
发 除	o 埃
发 此	o 
发 粗	o 彩
发 脆	o 
发 村	o 
发 大	o j
发 袋	o U
发 当	o 讽
发 到	o 
发 得	o o
发 的	o 
发 等	o 单
发 低	o C
发 第	o 材
发 店	o ┍
发 都	o 常
发 对	o 癸
发 多	o h
发 而	o τ
发 罚	o @
发 肤	o 涧
发 膏	o I
发 个	o 
发 各	o U
发 购	o 潦
发 过	o L
发 函	o ㄧ
发 航	o 
发 好	o n
发 呵	o 
发 和	o M
发 很	o 
发 红	o 
发 后	o 
发 黄	o 独
发 或	o ┪
发 货	o f
发 及	o の
发 佳	o ㄎ
发 家	o a
发 奖	o 贱
发 角	o à
发 接	o 钡
发 精	o 弘
发 井	o か
发 就	o N
发 局	o Ы
发 开	o }
发 可	o i
发 奎	o 
发 拉	o ┰
发 来	o ㄓ
发 廊	o Y
发 老	o ρ
发 离	o 瞒
发 礼	o 搂
发 力	o O
发 了	o F
发 裂	o 吊
发 林	o L
发 零	o s
发 令	o O
发 螺	o 脸
发 满	o 骸
发 没	o S
发 面	o 
发 努	o V
发 女	o k
发 炮	o 
发 配	o t
发 品	o ~
发 期	o 戳
发 青	o C
发 清	o M
发 庆	o y
发 球	o y
发 区	o 跋
发 去	o h
发 全	o 
发 券	o ㄩ
发 却	o o
发 染	o V
发 人	o H
发 软	o n
发 三	o T
发 傻	o 短
发 善	o 到
发 少	o ぶ
发 身	o ō
发 省	o 
发 师	o v
发 十	o Q
发 时	o 
发 式	o Α
发 势	o 墩
发 是	o O
发 市	o カ
发 水	o 
发 说	o 弧
发 丝	o 捣
发 宋	o Ш
发 速	o t
发 他	o L
发 塔	o 娥
发 烫	o S
发 田	o バ
发 童	o 担
发 投	o щ
发 推	o 崩
发 外	o ~
发 万	o U
发 为	o 
发 卧	o 
发 屋	o 
发 洗	o ~
发 乡	o m
发 向	o V
发 新	o s
发 型	o 
发 性	o ┦
发 蓄	o W
发 言	o ē
发 央	o ァ
发 扬	o 喘
发 痒	o }
发 也	o ]
发 业	o ~
发 一	o @
发 依	o ㄌ
发 椅	o 慈
发 用	o ノ
发 员	o 
发 运	o B
发 在	o b
发 债	o 杜
发 症	o g
发 证	o 谍
发 职	o 戮
发 至	o 
发 制	o 
发 中	o い
发 终	o 沧
发 重	o 
发 著	o 帝
发 抓	o ъ
发 紫	o 档
发 自	o 
发 做	o 暗
罚款 并	@蹿 }
乏 出	F X
乏 疗	F 励
阀 万	恢 U
法国 并	k瓣 }
法国 格	k瓣 
法律 并	k }
法学家 们	k厩a 
法学家 钱	k厩a 窥
法语 并	ky }
法治国 家	kv瓣 a
法 并	k }
法 共	k @
法 伦	k 
法 托	k Λ
帆布 自	|ガ 
帆 板	| O
翻译 家	陆亩 a
翻 出	陆 X
翻 斗	陆 矮
繁多 并	ch }
繁育 出	c| X
烦恼 是	沸o O
反驳 道	は婚 D
反驳 了	は婚 F
反共 的	は@ 
反共 反	は@ は
反共 拒	は@ ┶
反射 板	はg O
反映 出	はM X
反映 万	はM U
反 扑	は 汲
返家 吧	甬a a
返家 当	甬a 讽
返家 的	甬a 
范 并	S }
范 家	S a
范 敬	S q
贩 并	c }
饭菜 票	逗垫 布
饭菜 质	逗垫 借
饭店 并	逗┍ }
泛 出	x X
方案 并	よ }
方法 逼	よk G
方面 并	よ }
方面 共	よ @
方式 签	よΑ 帽
方 发	よ o
方 家	よ a
方 签	よ 帽
房子 塌	┬l 厄
房 出	┬ X
防洪 堤	粳x 出
防患 于	颈w _
防守 并	睛u }
防止 并	兢 }
防 并	 }
防 术	 N
妨碍 布	Й锚 ガ
访问团 莅	X拜刮 Y
访 敬	X q
访 苏	X 默
访 万	X U
纺织厂 家	悸醇t a
放出 铅	癀X ]
放出 上	癀X W
放映 并	瘳M }
放映 出	瘳M X
放 扶	 н
放 疗	 励
菲 舍	滇 
非常 丰	D` 伦
非常 坚	D` 绊
非战斗人员 将	D驹矮H N
非战斗人员 外	D驹矮H ~
非洲 杯	Dw M
非 采	D 蹦
非 出	D X
非 婚	D B
飞 铲	 藐
飞 出	 X
肥 发	 o
匪首 程	戥 {
匪 浅	 L
匪 中	 い
费 伦	O 
芬 共	 @
芬 苏	 默
分别 出	だO X
分发 到	だo 
分发 就	だo N
分局 共	だЫ @
分离 出	だ瞒 X
分娩 才	だY ~
分娩 了	だY F
分娩 也	だY ]
分配 额	だt B
分歧 并	だ[ }
分散 并	だ床 }
分散 布	だ床 ガ
分庭抗礼 的	だxк搂 
分析家 的	だRa 
分析家 对	だRa 癸
分析家 们	だRa 
分析家 说	だRa 弧
分析家 所	だRa ┮
分析家 在	だRa b
分析 并	だR }
分析 发	だR o
分析 丰	だR 伦
分子 并	だl }
分子 敬	だl q
分 并	だ }
分 布	だ ガ
分 出	だ X
纷纷 出	莎 X
纷纷 发	莎 o
粉 妆	 З
奋斗 把	灸矮 р
奋斗 不	灸矮 ぃ
奋斗 的	灸矮 
奋斗 等	灸矮 单
奋斗 和	灸矮 M
奋斗 了	灸矮 F
奋斗 路	灸矮 隔
奋斗 模	灸矮 家
奋斗 去	灸矮 h
奋斗 使	灸矮 ㄏ
奋斗 是	灸矮 O
奋斗 为	灸矮 
奋斗 下	灸矮 U
奋斗 相	灸矮 
奋斗 在	灸矮 b
奋斗 之	灸矮 ぇ
奋斗 中	灸矮 い
奋斗 终	灸矮 沧
奋斗 做	灸矮 暗
奋发图强 的	灸o瓜j 
奋发向上 的	灸oVW 
奋发 的	灸o 
奋发 赶	灸o 话
份数 万	骷 U
份 额	 B
份 发	 o
份 共	 @
愤慨 并	极n }
丰饶 芜	伦那 烤
丰润 县	伦柬 郡
丰润 站	伦柬 
丰 碑	伦 O
丰 补	伦 干
丰 采	伦 蹦
丰 草	伦 
丰 产	伦 玻
丰 的	伦 
丰 登	伦 n
丰 度	伦 
丰 富	伦 I
丰 功	伦 \
丰 和	伦 M
丰 厚	伦 p
丰 华	伦 地
丰 凯	伦 惩
丰 离	伦 瞒
丰 林	伦 L
丰 禄	伦 S
丰 满	伦 骸
丰 美	伦 
丰 民	伦 チ
丰 南	伦 n
丰 年	伦 ~
丰 歉	伦 p
丰 去	伦 h
丰 塞	伦 峨
丰 盛	伦 脖
丰 收	伦 Μ
丰 说	伦 弧
丰 硕	伦 河
丰 台	伦 x
丰 田	伦 バ
丰 威	伦 
丰 县	伦 郡
丰 乡	伦 m
丰 雄	伦 动
丰 衣	伦 
丰 以	伦 H
丰 盈	伦 
丰 裕	伦 肝
丰 在	伦 b
丰 镇	伦 马
丰 转	伦 锣
丰 姿	伦 
丰 足	伦 ì
丰 胄	伦 `
丰 稔	伦 Z
蜂 采	噶 蹦
峰 托	p Λ
锋 并	W }
锋 出	W X
锋 树	W 攫
风尘仆仆 地	饭泄补 a
风尘仆仆 赶	饭泄补 话
风格 别	樊 O
风格 不	樊 ぃ
风格 的	樊 
风格 各	樊 U
风格 给	樊 倒
风格 古	樊 j
风格 和	樊 M
风格 久	樊 [
风格 均	樊 А
风格 里	樊 
风格 使	樊 ㄏ
风格 也	樊 ]
风格 已	樊 w
风格 有	樊 Τ
风力发电机 等	筏Ooq诀 单
风沙 漫	法F 憨
风险 共	防I @
风 采	 蹦
风 发	 o
冯 家	毒 a
奉献 出	^m X
凤凰 杯	获澳 M
凤凰 树	获澳 攫
凤 斗	获 矮
否认 苏	_{ 默
夫人 共	ひH @
夫 出	ひ X
夫 舍	ひ 
夫 万	ひ U
扶持 陈	н 朝
扶持 大	н j
扶持 的	н 
扶持 费	н O
扶持 高	н 蔼
扶持 各	н U
扶持 和	н M
扶持 款	н 蹿
扶持 老	н ρ
扶持 了	н F
扶持 棉	н 粗
扶持 奶	н イ
扶持 农	н A
扶持 其	н ㄤ
扶持 起	н _
扶持 青	н C
扶持 全	н 
扶持 是	н O
扶持 他	н L
扶持 特	н S
扶持 外	н ~
扶持 威	н 
扶持 魏	н Q
扶持 我	н и
扶持 下	н U
扶持 县	н 郡
扶持 小	н p
扶持 一	н @
扶持 优	н u
扶持 咱	н 
扶持 中	н い
扶老携幼 踏	нρ拟ギ 今
扶老携幼 拥	нρ拟ギ 局
扶老携幼 涌	нρ拟ギ F
扶起 来	н_ ㄓ
扶养 残	нi 摧
扶植 的	н从 
扶植 老	н从 ρ
扶植 了	н从 F
扶植 职	н从 戮
扶助 百	нU κ
扶助 老	нU ρ
扶 残	н 摧
扶 村	н 
扶 到	н 
扶 沟	н 肪
扶 科	н 
扶 困	н x
扶 犁	н p
扶 您	н z
扶 贫	н h
扶 墙	н 鲤
扶 桑	н 
扶 上	н W
扶 他	н L
扶 一	н @
扶 优	н u
扶 幼	н ギ
扶 正	н タ
扶 著	н 帝
扶 住	н 
拂晓 前	┴惧 e
拂晓 时	┴惧 
幅 布	T ガ
氟化物 并	tて }
伏击 并	ヱ阑 }
伏 家	ヱ a
伏 秋	ヱ 
服从 并	Aq }
服务人员 共	A叭H @
浮雕 壁	BJ 纠
浮雕 是	BJ O
浮现 出	B{ X
浮 出	B X
福 格	褐 
福 家	褐 a
福 万	褐 U
弗 格	ケ 
弗 伦	ケ 
辅导 串	徊旧 
赴 苏	u 默
副部长 布	捌场 ガ
副部长 格	捌场 
副部长 万	捌场 U
副局长 布	捌Ы ガ
副局长 佩	捌Ы ㄘ
副总统 出	捌`参 X
覆盖 丰	滦\ 伦
复发 的	_o 
复发 了	_o F
复发 率	_o v
复苏 的	_默 
复苏 将	_默 N
复苏 也	_默 ]
复 出	_ X
傅 家	撑 a
付出 比	IX ゑ
付出 的	IX 
付出 高	IX 蔼
付出 更	IX 
付出 过	IX L
付出 艰	IX }
付出 了	IX F
付出 辛	IX ǒ
付出 再	IX A
付诸实施 并	I窖龟I }
付 额	I B
付 家	I a
腹部 划	浮场 购
负责 并	td }
负责 共	td @
富翁 特	I S
富 并	I }
富 家	I a
妇女 发	包k o
妇女 丰	包k 伦
妇女 共	包k @
妇女 家	包k a
嘎 家	骨 a
该 并	赣 }
改革 出	э X
改革 丰	э 伦
改正 的	эタ 
改正 和	эタ M
改 出	э X
概况 和	阀p M
概况 检	阀p 浪
概括 出	阀A X
概要 地	阀n a
盖板 的	\O 
盖板 等	\O 单
盖板 会	\O |
盖板 死	\O 
盖板 下	\O U
盖 格	\ 
盖 帽	\ U
干部 发	F场 o
干部 共	F场 @
干 杯	F M
干 布	F ガ
干 出	F X
干 发	F o
干 共	F @
干 家	F a
甘 布	ヌ ガ
甘 家	ヌ a
赶出去 的	话Xh 
赶出 城	话X 
赶出 了	话X F
赶出 原	话X 
赶到 家	话 a
赶上 并	话W }
感激万分 地	PEUだ a
感觉 出	P谋 X
感慨万千 地	PnUd a
感慨 万	Pn U
感谢 并	P谅 }
感 并	P }
敢 焊	幢 k
敢 藐	幢 缕
冈 矮	 G
冈 家	 a
刚 出	 X
刚 家	 a
钢板 仓	葵O 
钢板 和	葵O M
钢板 粘	葵O 诌
钢琴家 肖	葵^a v
钢琴家 约	葵^a 
钢丝 发	葵捣 o
钢 杯	葵 M
钢 斗	葵 矮
港口 共	翠f @
港 杯	翠 M
港 共	翠 @
高级官员 布	蔼农x ガ
高原气候 的	蔼飚瓠 
高 矮	蔼 G
高 昂	蔼 
高 板	蔼 O
高 并	蔼 }
高 采	蔼 蹦
高 出	蔼 X
高 额	蔼 B
高 发	蔼 o
高 家	蔼 a
高 疗	蔼 励
搞 出	d X
告别仪式 并	iO祸Α }
哥哥 出	舡 X
哥哥 家	舡 a
哥伦比亚 安	舡郅瘿 w
哥伦比亚 被	舡郅瘿 Q
哥伦比亚 布	舡郅瘿 ガ
哥伦比亚 从	舡郅瘿 q
哥伦比亚 大	舡郅瘿 j
哥伦比亚 的	舡郅瘿 
哥伦比亚 等	舡郅瘿 单
哥伦比亚 队	舡郅瘿 钉
哥伦比亚 贩	舡郅瘿 c
哥伦比亚 和	舡郅瘿 M
哥伦比亚 极	舡郅瘿 伐
哥伦比亚 检	舡郅瘿 浪
哥伦比亚 居	舡郅瘿 ~
哥伦比亚 卡	舡郅瘿 d
哥伦比亚 乔	舡郅瘿 踌
哥伦比亚 人	舡郅瘿 H
哥伦比亚 扫	舡郅瘿 苯
哥伦比亚 省	舡郅瘿 
哥伦比亚 圣	舡郅瘿 t
哥伦比亚 是	舡郅瘿 O
哥伦比亚 水	舡郅瘿 
哥伦比亚 也	舡郅瘿 ]
哥伦比亚 伊	舡郅瘿 レ
哥伦比亚 已	舡郅瘿 w
哥伦比亚 优	舡郅瘿 u
哥伦比亚 在	舡郅瘿 b
哥伦比亚 占	舡郅瘿 
哥伦比亚 中	舡郅瘿 い
哥伦比亚 驻	舡郅瘿 n
哥伦比亚 抓	舡郅瘿 ъ
哥伦比亚 总	舡郅瘿 `
哥伦比亚 最	舡郅瘿 程
哥 布	 ガ
歌唱家 才	q佰a ~
歌唱家 德	q佰a w
歌唱家 翟	q佰a C
歌唱家 董	q佰a 赋
歌唱家 关	q佰a 闽
歌唱家 和	q佰a M
歌唱家 姜	q佰a 
歌唱家 蒋	q佰a 奖
歌唱家 李	q佰a 
歌唱家 们	q佰a 
歌唱家 彭	q佰a ^
歌唱家 万	q佰a U
歌唱家 吴	q佰a d
歌唱家 殷	q佰a 
歌唱家 之	q佰a ぇ
歌曲 发	qΡ o
歌曲 共	qΡ @
歌仔戏 史	qJ栏 v
歌 并	q }
歌 丰	q 伦
鸽 并	F }
割 舍	澄 
革命家 的	博Ra 
革命家 缔	博Ra l
革命家 对	博Ra 癸
革命家 和	博Ra M
革命家 将	博Ra N
革命家 开	博Ra }
革命家 题	博Ra D
革命家 为	博Ra 
革命家 乌	博Ra Q
革命家 向	博Ra V
格调 的	娼 
格调 古	娼 j
格调 要	娼 n
格局 不	妲 ぃ
格局 的	妲 
格局 和	妲 M
格局 还	妲 临
格局 仍	妲 ご
格局 上	妲 W
格局 虽	妲 瘤
格局 未	妲 ゼ
格局 新	妲 s
格局 已	妲 w
格局 在	妲 b
格局 中	妲 い
格林 汉	妾L ~
格林 科	妾L 
格林 纳	妾L 
格林 尼	妾L ェ
格林 斯	妾L 吹
格林 于	妾L _
格式 由	姒 パ
格外 高	妤~ 蔼
格外 艰	妤~ }
格外 浓	妤~ @
格外 抢	妤~ m
格外 亲	妤~ 克
格外 惹	妤~ S
格外 耀	妤~ 模
格 奥	 而
格 把	 р
格 班	 Z
格 邦	 ü
格 比	 ゑ
格 并	 }
格 勃	 k
格 查	 d
格 从	 q
格 达	 F
格 但	 
格 到	 
格 道	 D
格 德	 w
格 的	 
格 对	 癸
格 尔	 焊
格 甘	 ヌ
格 格	 
格 给	 倒
格 古	 j
格 圭	 c
格 和	 M
格 还	 临
格 或	 ┪
格 吉	 N
格 将	 N
格 就	 N
格 拉	 ┰
格 来	 ㄓ
格 兰	 孽
格 勒	 扒
格 雷	 p
格 里	 
格 丽	 R
格 利	 Q
格 列	 C
格 陵	 钞
格 鲁	 |
格 罗	 霉
格 洛	 
格 玛	 嚎
格 曼	 耙
格 梅	 宾
格 木	 れ
格 纳	 
格 南	 n
格 内	 ず
格 尼	 ェ
格 年	 ~
格 涅	 I
格 努	 V
格 诺	 空
格 平	 キ
格 萨	 履
格 三	 T
格 桑	 
格 森	 此
格 上	 W
格 什	 ぐ
格 是	 O
格 说	 弧
格 斯	 吹
格 索	 
格 太	 び
格 特	 S
格 同	 P
格 微	 L
格 为	 
格 维	 蝴
格 现	 {
格 县	 郡
格 亚	 ㄈ
格 扬	 喘
格 一	 @
格 已	 w
格 由	 パ
格 在	 b
格 则	 h
格 扎	 蚕
格 吱	 s
格 致	 P
格 州	 {
格 转	 锣
隔板 的	jO 
隔膜 布	j饯 ガ
隔日 出	jら X
隔音板 外	j氮O ~
隔 出	j X
个人 背	婴H I
个人 并	婴H }
个人 采	婴H 蹦
个人 发	婴H o
个体 采	优 蹦
个体 发	优 o
个 矮	 G
个 背	 I
个 采	 蹦
个 出	 X
个 额	 B
个 发	 o
个 丰	 伦
个 扶	 н
个 共	 @
个 家	 a
个 坚	 绊
个 敬	 q
个 疗	 励
个 秋	 
个 树	 攫
个 万	 U
各类 扶	U摸 н
各类 树	U摸 攫
各种 丰	U贺 伦
各种 扶	U贺 н
各种 术	U贺 N
各 布	U ガ
各 发	U o
各 共	U @
各 家	U a
给 板	倒 O
给 布	倒 ガ
给 丰	倒 伦
给 格	倒 
给 家	倒 a
给 签	倒 帽
给 苏	倒 默
给 万	倒 U
根本上 铲	讠护W 藐
根本 敬	讠 q
根据 签	诰 帽
根据 苏	诰 默
根治 术	讵v N
根 雕	 J
根 家	 a
根 颈	 V
根 舍	 
根 树	 攫
跟 斗	蛤 矮
耕地 并	薛a }
耕 秋	 
更加 昂	螗[ 
更加 丰	螗[ 伦
更加 坚	螗[ 绊
更生 布	螗 ガ
更 丰	 伦
工程 额	u{ B
工程 共	u{ @
工会 共	u| @
工人 并	uH }
工人 共	uH @
工人 家	uH a
工业国家 的	u~瓣a 
工业国家 都	u~瓣a 常
工业 布	u~ ガ
工资 发	u戈 o
工作报告 并	u@厨i }
工作量 共	u@q @
工作者 发	u@ o
工作 并	u@ }
工作 帽	u@ U
工 卜	u R
工 布	u ガ
工 出	u X
工 发	u o
工 共	u @
工 家	u a
工 签	u 帽
工 万	u U
攻坚 的	ю绊 
攻坚 战	ю绊 驹
功 并	\ }
恭敬 地	シq a
恭敬 敬	シq q
供给不足 并	ㄑ倒ぃì }
公报 办	そ厨 快
公报 避	そ厨 磷
公报 的	そ厨 
公报 对	そ厨 癸
公报 和	そ厨 M
公报 后	そ厨 
公报 呼	そ厨 I
公报 还	そ厨 临
公报 及	そ厨 の
公报 里	そ厨 
公报 是	そ厨 O
公报 说	そ厨 弧
公报 所	そ厨 ┮
公报 在	そ厨 b
公报 中	そ厨 い
公布 办	そガ 快
公布 得	そガ o
公布 的	そガ 
公布 第	そガ 材
公布 各	そガ U
公布 和	そガ M
公布 后	そガ 
公布 户	そガ め
公布 黄	そガ 独
公布 或	そガ ┪
公布 了	そガ F
公布 其	そガ ㄤ
公布 桑	そガ 
公布 世	そガ @
公布 我	そガ и
公布 新	そガ s
公布 业	そガ ~
公布 一	そガ @
公布 于	そガ _
公布 与	そガ P
公布 羽	そガ π
公布 这	そガ o
公布 组	そガ 舱
公布 最	そガ 程
公共厕所 的	そ@Z┮ 
公共厕所 等	そ@Z┮ 单
公共厕所 脏	そ@Z┮ 纽
公共工程 和	そ@u{ M
公共汽车站 去	そ@Tó h
公共汽车 被	そ@Tó Q
公共汽车 的	そ@Tó 
公共汽车 和	そ@Tó M
公共汽车 或	そ@Tó ┪
公共汽车 票	そ@Tó 布
公共汽车 去	そ@Tó h
公共汽车 上	そ@Tó W
公共汽车 又	そ@Tó S
公共汽车 在	そ@Tó b
公共汽车 中	そ@Tó い
公共汽车 坐	そ@Tó Г
公共设施 等	そ@]I 单
公共事业 的	そ@ㄆ~ 
公共事业 无	そ@ㄆ~ L
公共卫生 和	そ@矫ネ M
公共 班	そ@ Z
公共 的	そ@ 
公共 关	そ@ 闽
公共 和	そ@ M
公共 积	そ@ n
公共 建	そ@ 
公共 绿	そ@ 厚
公家 的	そa 
公家 店	そa ┍
公家 一	そa @
公仆 的	そ共 
公仆 情	そ共 薄
公顷 绿	そ臣 厚
公顷 水	そ臣 
公使 万	そㄏ U
公司 发	そq o
公司 共	そq @
公司 签	そq 帽
公司 万	そq U
巩固 疗	dT 励
贡献 出	^m X
贡 布	^ ガ
共产党员 安	@玻囊 w
共产党员 被	@玻囊 Q
共产党员 带	@玻囊 a
共产党员 到	@玻囊 
共产党员 的	@玻囊 
共产党员 访	@玻囊 X
共产党员 郭	@玻囊 尝
共产党员 号	@玻囊 腹
共产党员 和	@玻囊 M
共产党员 何	@玻囊 
共产党员 就	@玻囊 N
共产党员 李	@玻囊 
共产党员 刘	@玻囊 B
共产党员 龙	@玻囊 s
共产党员 沙	@玻囊 F
共产党员 宋	@玻囊 Ш
共产党员 索	@玻囊 
共产党员 王	@玻囊 
共产党员 为	@玻囊 
共产党员 肖	@玻囊 v
共产党员 谢	@玻囊 谅
共产党员 许	@玻囊 \
共产党员 严	@玻囊 Y
共产党员 杨	@玻囊 法
共产党员 要	@玻囊 n
共产党员 一	@玻囊 @
共产党员 应	@玻囊 莱
共产党员 用	@玻囊 ノ
共产党员 在	@玻囊 b
共产党员 占	@玻囊 
共产党员 张	@玻囊 i
共产党员 中	@玻囊 い
共产党员 周	@玻囊 P
共产党员 最	@玻囊 程
共产党 把	@玻囊 р
共产党 不	@玻囊 ぃ
共产党 成	@玻囊 Θ
共产党 处	@玻囊 B
共产党 从	@玻囊 q
共产党 带	@玻囊 a
共产党 党	@玻囊 囊
共产党 的	@玻囊 
共产党 等	@玻囊 单
共产党 第	@玻囊 材
共产党 缔	@玻囊 l
共产党 都	@玻囊 常
共产党 对	@玻囊 癸
共产党 好	@玻囊 n
共产党 和	@玻囊 M
共产党 艰	@玻囊 }
共产党 建	@玻囊 
共产党 将	@玻囊 N
共产党 就	@玻囊 N
共产党 来	@玻囊 ㄓ
共产党 两	@玻囊 ㄢ
共产党 内	@玻囊 ず
共产党 派	@玻囊 
共产党 亲	@玻囊 克
共产党 让	@玻囊 琵
共产党 人	@玻囊 H
共产党 是	@玻囊 O
共产党 贴	@玻囊 K
共产党 同	@玻囊 P
共产党 推	@玻囊 崩
共产党 象	@玻囊 H
共产党 要	@玻囊 n
共产党 也	@玻囊 ]
共产党 一	@玻囊 @
共产党 以	@玻囊 H
共产党 有	@玻囊 Τ
共产党 与	@玻囊 P
共产党 越	@玻囊 V
共产党 在	@玻囊 b
共产党 掌	@玻囊 x
共产党 这	@玻囊 o
共产党 走	@玻囊 ǐ
共产主义 不	@玻Dq ぃ
共产主义 的	@玻Dq 
共产主义 者	@玻Dq 
共产 果	@玻 G
共产 煤	@玻 费
共处 理	@B z
共处 于	@B _
共存 并	@s }
共存 的	@s 
共存 下	@s U
共党 史	@囊 v
共党 委	@囊 e
共和党 的	@M囊 
共和党 合	@M囊 X
共和党 两	@M囊 ㄢ
共和党 于	@M囊 _
共和国 报	@M瓣 厨
共和国 不	@M瓣 ぃ
共和国 从	@M瓣 q
共和国 党	@M瓣 囊
共和国 得	@M瓣 o
共和国 的	@M瓣 
共和国 地	@M瓣 a
共和国 队	@M瓣 钉
共和国 俄	@M瓣 X
共和国 防	@M瓣 
共和国 副	@M瓣 捌
共和国 关	@M瓣 闽
共和国 和	@M瓣 M
共和国 及	@M瓣 の
共和国 将	@M瓣 N
共和国 境	@M瓣 挂
共和国 就	@M瓣 N
共和国 均	@M瓣 А
共和国 两	@M瓣 ㄢ
共和国 抹	@M瓣 ┵
共和国 睦	@M瓣 伏
共和国 纳	@M瓣 
共和国 仍	@M瓣 ご
共和国 是	@M瓣 O
共和国 守	@M瓣 u
共和国 属	@M瓣 妮
共和国 所	@M瓣 ┮
共和国 同	@M瓣 P
共和国 为	@M瓣 
共和国 位	@M瓣 
共和国 乌	@M瓣 Q
共和国 一	@M瓣 @
共和国 已	@M瓣 w
共和国 议	@M瓣 某
共和国 因	@M瓣 ]
共和国 由	@M瓣 パ
共和国 与	@M瓣 P
共和国 在	@M瓣 b
共和国 这	@M瓣 o
共和国 之	@M瓣 ぇ
共和国 中	@M瓣 い
共和国 最	@M瓣 程
共和 各	@M U
共和 两	@M ㄢ
共和 三	@M T
共和 苏	@M 默
共和 县	@M 郡
共和 乡	@M m
共和 中	@M い
共计 有	@p Τ
共计 折	@p ч
共鸣 和	@伙 M
共青团 成	@C刮 Θ
共青团 的	@C刮 
共青团 等	@C刮 单
共青团 号	@C刮 腹
共青团 和	@C刮 M
共青团 既	@C刮 J
共青团 开	@C刮 }
共青团 深	@C刮 `
共青团 沈	@C刮 H
共青团 示	@C刮 ボ
共青团 是	@C刮 O
共青团 双	@C刮 蛮
共青团 同	@C刮 P
共青团 团	@C刮 刮
共青团 县	@C刮 郡
共青团 要	@C刮 n
共青团 员	@C刮 
共青团 扎	@C刮 蚕
共青团 转	@C刮 锣
共青团 总	@C刮 `
共生 产	@ネ 玻
共生 固	@ネ T
共生 矿	@ネ q
共识 的	@醚 
共识 或	@醚 ┪
共事 的	@ㄆ 
共事 关	@ㄆ 闽
共事 所	@ㄆ ┮
共事 中	@ㄆ い
共同安全 防	@Pw 
共同目标 而	@Pヘ夹 τ
共同目标 下	@Pヘ夹 U
共同努力 把	@PVO р
共同努力 的	@PVO 
共同努力 搞	@PVO d
共同努力 来	@PVO ㄓ
共同努力 能	@PVO 
共同努力 去	@PVO h
共同努力 使	@PVO ㄏ
共同努力 下	@PVO U
共同声明 的	@Pn 
共同市场 成	@Pカ初 Θ
共同市场 的	@Pカ初 
共同市场 对	@Pカ初 癸
共同市场 建	@Pカ初 
共同市场 将	@Pカ初 N
共同市场 由	@Pカ初 パ
共同市场 在	@Pカ初 b
共同市场 作	@Pカ初 @
共同性 的	@P┦ 
共同研究 成	@P悒s Θ
共同研究 大	@P悒s j
共同研究 的	@P悒s 
共同 把	@P р
共同 奔	@P b
共同 编	@P s
共同 筹	@P w
共同 创	@P 承
共同 大	@P j
共同 的	@P 
共同 地	@P a
共同 缔	@P l
共同 点	@P I
共同 对	@P 癸
共同 防	@P 
共同 负	@P t
共同 感	@P P
共同 高	@P 蔼
共同 搞	@P d
共同 各	@P U
共同 横	@P 绢
共同 呼	@P I
共同 话	@P 杠
共同 欢	@P w
共同 交	@P ユ
共同 经	@P g
共同 举	@P |
共同 开	@P }
共同 抗	@P к
共同 来	@P ㄓ
共同 谋	@P 垦
共同 拍	@P ╃
共同 商	@P 坝
共同 社	@P 
共同 审	@P f
共同 特	@P S
共同 体	@P 砰
共同 填	@P 恶
共同 条	@P 兵
共同 为	@P 
共同 向	@P V
共同 协	@P 
共同 携	@P 拟
共同 心	@P み
共同 学	@P 厩
共同 研	@P 
共同 迎	@P 
共同 与	@P P
共同 之	@P ぇ
共同 主	@P D
共同 抓	@P ъ
共同 组	@P 舱
共同 做	@P 暗
共享 的	@ㄉ 
共用 汇	@ノ 蹲
共用 蒙	@ノ X
共用 制	@ノ 
共有 艾	@Τ 
共有 藏	@Τ 旅
共有 磁	@Τ 合
共有 从	@Τ q
共有 党	@Τ 囊
共有 帆	@Τ |
共有 坟	@Τ X
共有 各	@Τ U
共有 国	@Τ 瓣
共有 近	@Τ 
共有 举	@Τ |
共有 黎	@Τ 兢
共有 两	@Τ ㄢ
共有 六	@Τ せ
共有 陆	@Τ 嘲
共有 盟	@Τ 幅
共有 女	@Τ k
共有 七	@Τ C
共有 十	@Τ Q
共有 四	@Τ |
共有 僳	@Τ 圄
共有 外	@Τ ~
共有 五	@Τ き
共有 县	@Τ 郡
共有 乡	@Τ m
共有 小	@Τ p
共有 宜	@Τ y
共有 以	@Τ H
共有 拥	@Τ 局
共有 职	@Τ 戮
共有 专	@Τ M
共 八	@ K
共 百	@ κ
共 办	@ 快
共 保	@ O
共 奔	@ b
共 病	@ f
共 播	@ 冀
共 拨	@ 挤
共 才	@ ~
共 采	@ 蹦
共 查	@ d
共 拆	@ ╊
共 长	@ 
共 超	@ W
共 撤	@ M
共 乘	@ 
共 承	@ ┯
共 抽	@ ┾
共 筹	@ w
共 出	@ X
共 创	@ 承
共 从	@ q
共 促	@ P
共 达	@ F
共 打	@ ゴ
共 带	@ a
共 担	@ 踞
共 丹	@ う
共 得	@ o
共 的	@ 
共 第	@ 材
共 调	@ 秸
共 订	@ q
共 东	@ F
共 度	@ 
共 渡	@ 寸
共 对	@ 癸
共 夺	@ 管
共 繁	@ c
共 分	@ だ
共 封	@ 
共 副	@ 捌
共 复	@ _
共 负	@ t
共 富	@ I
共 各	@ U
共 给	@ 倒
共 更	@ 
共 购	@ 潦
共 管	@ 恨
共 过	@ L
共 海	@ 
共 核	@ 
共 贺	@ P
共 话	@ 杠
共 欢	@ w
共 换	@ 传
共 惠	@ f
共 混	@ V
共 获	@ 莉
共 基	@ 膀
共 及	@ の
共 济	@ 蕾
共 寄	@ H
共 加	@ [
共 检	@ 浪
共 建	@ 
共 将	@ N
共 讲	@ 量
共 交	@ ユ
共 缴	@ 煤
共 接	@ 钡
共 节	@ `
共 结	@ 挡
共 界	@ 
共 进	@ i
共 净	@ b
共 九	@ E
共 举	@ |
共 聚	@ E
共 捐	@ 
共 决	@ M
共 开	@ }
共 兰	@ 孽
共 理	@ z
共 立	@ ミ
共 两	@ ㄢ
共 六	@ せ
共 漏	@ |
共 旅	@ 
共 盟	@ 幅
共 猛	@ r
共 闹	@ x
共 念	@ ├
共 派	@ 
共 培	@ 蚌
共 评	@ 蝶
共 七	@ C
共 签	@ 帽
共 前	@ e
共 欠	@ ろ
共 抢	@ m
共 青	@ C
共 清	@ M
共 庆	@ y
共 泉	@ u
共 确	@ T
共 人	@ H
共 赛	@ 辽
共 三	@ T
共 商	@ 坝
共 赏	@ 洁
共 上	@ W
共 设	@ ]
共 深	@ `
共 沈	@ H
共 使	@ ㄏ
共 是	@ O
共 收	@ Μ
共 售	@ 扳
共 朔	@ 
共 私	@ p
共 四	@ |
共 诉	@ D
共 绥	@ k
共 损	@ l
共 踢	@ 金
共 提	@ 矗
共 体	@ 砰
共 天	@ ぱ
共 添	@ K
共 停	@ 氨
共 通	@ q
共 投	@ щ
共 图	@ 瓜
共 万	@ U
共 为	@ 
共 五	@ き
共 舞	@ R
共 献	@ m
共 向	@ V
共 销	@ P
共 新	@ s
共 性	@ ┦
共 需	@ 惠
共 叙	@ 痹
共 学	@ 厩
共 研	@ 
共 要	@ n
共 也	@ ]
共 一	@ @
共 宜	@ y
共 议	@ 某
共 译	@ 亩
共 饮	@ 都
共 印	@ L
共 迎	@ 
共 涌	@ F
共 由	@ パ
共 与	@ P
共 育	@ |
共 愿	@ @
共 约	@ 
共 运	@ B
共 栽	@ 
共 在	@ b
共 赞	@ g
共 葬	@ 府
共 增	@ W
共 展	@ i
共 占	@ 
共 战	@ 驹
共 征	@ ┖
共 整	@ 俱
共 知	@ 
共 植	@ 从
共 制	@ 
共 治	@ v
共 重	@ 
共 筑	@ 诞
共 住	@ 
共 驻	@ n
共 抓	@ ъ
共 装	@ 杆
共 撞	@ 疾
共 追	@ l
共 组	@ 舱
共 钻	@ p
共 最	@ 程
共 做	@ 暗
共 坐	@ Г
共 沭	@ 条
钩 共	_ @
勾勒 出	つ扒 X
沟渠 林	肪措 L
沟渠 纵	肪措 a
沟通 苏	肪q 默
沟 万	肪 U
购买 串	潦R 
购买 额	潦R B
够 丰	镑 伦
够 格	镑 
估计 并	舡p }
估计 布	舡p ガ
鼓吹 并	躬j }
鼓舞 斗	躬R 矮
鼓胀 的	躬等 
古巴 杯	jぺ M
古迹 的	j格 
古迹 和	j格 M
古柯 树	j_ 攫
古生物学 家	jネ厩 a
古 格	j 
古 共	j @
古 树	j 攫
骨质疏松症 患	癌借波Pg w
骨 杯	癌 M
谷 斗	é 矮
谷 丰	é 伦
股份有限公司 等	靴鳓抄そq 单
股 额	 B
故事片 共	Gㄆ @
故乡 并	Gm }
顾及 家	Uの a
顾家 骥	Ua k
顾客 家	U a
顾 树	U 攫
顾 万	U U
固定 术	Tw N
雇员 踢	侗 金
雇员 也	侗 ]
雇员 与	侗 P
雇员 中	侗 い
挂念 家	本├ a
挂 出	本 X
棺 板	疵 O
棺 共	疵 @
关心 发	闽み o
关注 并	闽` }
官兵 发	xL o
官兵 共	xL @
官方公报 说	xよそ厨 弧
官员 布	x ガ
官 布	x ガ
官 家	x a
官 帽	x U
冠军赛 共	ax辽 @
冠军 杯	ax M
冠军 布	ax ガ
冠军 邢	ax ǚ
冠 帽	a U
观测 采	[代 蹦
观察家 奥	[诡a 而
观察家 的	[诡a 
观察家 们	[诡a 
观看 并	[ }
观赏 树	[洁 攫
观 并	[ }
管道 焊	恨D k
管理 并	恨z }
管弦乐 交	恨┒贾 ユ
管 并	恨 }
管 布	恨 ガ
管 苏	恨 默
馆 共	] @
灌 出	拈 X
贯 串	e 
光辉 并	谨 }
光谱 术	眯 N
光束 在	 b
光 板	 O
光 逼	 G
光 采	 蹦
光 缎	 v
光 家	 a
广东 共	sF @
广东 签	sF 帽
广东 万	sF U
广为宣传 和	s矮哦 M
广州 敬	s{ q
广州 万	s{ U
规格 不	W ぃ
规格 的	W 
规格 等	W 单
规格 复	W _
规格 各	W U
规格 和	W M
规格 化	W て
规格 基	W 膀
规格 建	W 
规格 较	W 耕
规格 品	W ~
规格 属	W 妮
规格 型	W 
规格 研	W 
规格 也	W ]
规格 最	W 程
规划 并	W购 }
规划 布	W购 ガ
归家 脚	ka }
归家 之	ka ぇ
归纳 出	k X
轨迹 可	y格 i
桂花 树	郦 攫
桂树 自	劬 
贵州 家	Q{ a
贵族 家	Q壁 a
贵 家	Q a
贵 溪	Q 匪
滚出 来	uX ㄓ
滚出 去	uX h
郭 丰	尝 伦
郭 家	尝 a
郭 秋	尝 
郭 树	尝 攫
郭 溪	尝 匪
国防部长 布	瓣境― ガ
国防部长 舍	瓣境― 
国防部长 托	瓣境― Λ
国画 家	瓣e a
国际法 并	瓣悔k }
国际 杯	瓣悔 M
国家安全法 应	瓣awk 莱
国家银行 将	瓣a蝗 N
国家银行 行	瓣a蝗 
国家银行 在	瓣a蝗 b
国家预算 而	瓣aw衡 τ
国家预算 内	瓣aw衡 ず
国家预算 是	瓣aw衡 O
国家预算 中	瓣aw衡 い
国家预算 做	瓣aw衡 暗
国家元首 的	瓣aじ 
国家元首 和	瓣aじ M
国家元首 杰	瓣aじ 城
国家元首 罗	瓣aじ 霉
国家元首 塔	瓣aじ 娥
国家主义 等	瓣aDq 单
国家 按	瓣a 
国家 把	瓣a р
国家 颁	瓣a {
国家 帮	瓣a 腊
国家 包	瓣a ]
国家 保	瓣a O
国家 报	瓣a 厨
国家 豹	瓣a \
国家 杯	瓣a M
国家 被	瓣a Q
国家 标	瓣a 夹
国家 兵	瓣a L
国家 拨	瓣a 挤
国家 补	瓣a 干
国家 不	瓣a ぃ
国家 部	瓣a 场
国家 才	瓣a ~
国家 长	瓣a 
国家 敞	瓣a 疮
国家 成	瓣a Θ
国家 出	瓣a X
国家 储	瓣a x
国家 处	瓣a B
国家 创	瓣a 承
国家 从	瓣a q
国家 大	瓣a j
国家 代	瓣a N
国家 的	瓣a 
国家 等	瓣a 单
国家 低	瓣a C
国家 电	瓣a q
国家 调	瓣a 秸
国家 都	瓣a 常
国家 队	瓣a 钉
国家 对	瓣a 癸
国家 多	瓣a h
国家 夺	瓣a 管
国家 而	瓣a τ
国家 二	瓣a G
国家 发	瓣a o
国家 返	瓣a 
国家 范	瓣a S
国家 方	瓣a よ
国家 分	瓣a だ
国家 副	瓣a 捌
国家 负	瓣a t
国家 干	瓣a F
国家 高	瓣a 蔼
国家 搞	瓣a d
国家 各	瓣a U
国家 给	瓣a 倒
国家 更	瓣a 
国家 工	瓣a u
国家 共	瓣a @
国家 古	瓣a j
国家 关	瓣a 闽
国家 好	瓣a n
国家 和	瓣a M
国家 横	瓣a 绢
国家 后	瓣a 
国家 呼	瓣a I
国家 划	瓣a 购
国家 化	瓣a て
国家 还	瓣a 临
国家 黄	瓣a 独
国家 或	瓣a ┪
国家 基	瓣a 膀
国家 及	瓣a の
国家 级	瓣a 
国家 计	瓣a p
国家 既	瓣a J
国家 间	瓣a 丁
国家 检	瓣a 浪
国家 减	瓣a 搭
国家 鉴	瓣a 懦
国家 建	瓣a 
国家 将	瓣a N
国家 交	瓣a ユ
国家 教	瓣a 毙
国家 较	瓣a 耕
国家 节	瓣a `
国家 金	瓣a 
国家 紧	瓣a 候
国家 近	瓣a 
国家 尽	瓣a 荷
国家 经	瓣a g
国家 净	瓣a b
国家 就	瓣a N
国家 局	瓣a Ы
国家 举	瓣a |
国家 卷	瓣a 
国家 均	瓣a А
国家 开	瓣a }
国家 看	瓣a 
国家 扛	瓣a Κ
国家 抗	瓣a к
国家 科	瓣a 
国家 可	瓣a i
国家 控	瓣a 北
国家 来	瓣a ㄓ
国家 蓝	瓣a 屡
国家 里	瓣a 
国家 利	瓣a Q
国家 立	瓣a ミ
国家 力	瓣a O
国家 粮	瓣a 鲁
国家 两	瓣a ㄢ
国家 了	瓣a F
国家 列	瓣a C
国家 留	瓣a d
国家 路	瓣a 隔
国家 旅	瓣a 
国家 民	瓣a チ
国家 谋	瓣a 垦
国家 男	瓣a k
国家 呢	瓣a O
国家 内	瓣a ず
国家 能	瓣a 
国家 年	瓣a ~
国家 女	瓣a k
国家 排	瓣a 逼
国家 派	瓣a 
国家 培	瓣a 蚌
国家 评	瓣a 蝶
国家 签	瓣a 帽
国家 前	瓣a e
国家 欠	瓣a ろ
国家 强	瓣a j
国家 穷	瓣a a
国家 去	瓣a h
国家 全	瓣a 
国家 让	瓣a 琵
国家 仍	瓣a ご
国家 三	瓣a T
国家 扫	瓣a 苯
国家 色	瓣a 
国家 商	瓣a 坝
国家 上	瓣a W
国家 尚	瓣a |
国家 省	瓣a 
国家 时	瓣a 
国家 使	瓣a ㄏ
国家 是	瓣a O
国家 收	瓣a Μ
国家 售	瓣a 扳
国家 受	瓣a 
国家 输	瓣a 块
国家 数	瓣a 计
国家 双	瓣a 蛮
国家 水	瓣a 
国家 税	瓣a |
国家 说	瓣a 弧
国家 四	瓣a |
国家 虽	瓣a 瘤
国家 所	瓣a ┮
国家 踏	瓣a 今
国家 体	瓣a 砰
国家 添	瓣a K
国家 田	瓣a バ
国家 通	瓣a q
国家 同	瓣a P
国家 统	瓣a 参
国家 危	瓣a M
国家 为	瓣a 
国家 无	瓣a L
国家 先	瓣a 
国家 现	瓣a {
国家 向	瓣a V
国家 小	瓣a p
国家 效	瓣a 
国家 新	瓣a s
国家 信	瓣a H
国家 研	瓣a 
国家 要	瓣a n
国家 也	瓣a ]
国家 一	瓣a @
国家 已	瓣a w
国家 以	瓣a H
国家 因	瓣a ]
国家 银	瓣a 蝗
国家 应	瓣a 莱
国家 用	瓣a ノ
国家 优	瓣a u
国家 油	瓣a o
国家 有	瓣a Τ
国家 又	瓣a S
国家 与	瓣a P
国家 语	瓣a y
国家 再	瓣a A
国家 在	瓣a b
国家 遭	瓣a D
国家 则	瓣a h
国家 增	瓣a W
国家 曾	瓣a 纯
国家 展	瓣a i
国家 这	瓣a o
国家 正	瓣a タ
国家 之	瓣a ぇ
国家 指	瓣a 
国家 只	瓣a u
国家 制	瓣a 
国家 治	瓣a v
国家 中	瓣a い
国家 主	瓣a D
国家 驻	瓣a n
国家 专	瓣a M
国家 准	瓣a 
国家 自	瓣a 
国家 总	瓣a `
国家 最	瓣a 程
国家 做	瓣a 暗
国家 作	瓣a @
国内 并	瓣ず }
国务院 扶	瓣叭| н
国务院 共	瓣叭| @
国务 家	瓣叭 a
国 并	瓣 }
国 出	瓣 X
国 发	瓣 o
国 格	瓣 
国 共	瓣 @
国 签	瓣 帽
国 万	瓣 U
果树 缠	G攫 鸟
果树 的	G攫 
果树 等	G攫 单
果树 低	G攫 C
果树 丢	G攫 メ
果树 丰	G攫 伦
果树 患	G攫 w
果树 科	G攫 
果树 林	G攫 L
果树 苗	G攫 ]
果树 明	G攫 
果树 年	G攫 ~
果树 品	G攫 ~
果树 缺	G攫 
果树 系	G攫 t
果树 下	G攫 U
果树 养	G攫 i
果树 有	G攫 Τ
果树 园	G攫 堕
果树 株	G攫 
果 丰	G 伦
果 共	G @
过量 采	Lq 蹦
过滤 布	Lo ガ
过去 扶	Lh н
过去 漫	Lh 憨
过手 并	Lも }
过 布	L ガ
过 堤	L 出
过 家	L a
过 漫	L 憨
过 苏	L 默
哈尔滨 采	⒑咐 蹦
哈密瓜 之	⒈Kナ ぇ
哈 卜	 R
哈 布	 ガ
哈 格	 
哈 伦	 
哈 默	 q
哈 托	 Λ
孩子家 庭	膜la x
孩子 并	膜l }
孩子 出	膜l X
孩子 扑	膜l 汲
海堤 冲	出 R
海底 布	┏ ガ
海关 并	闽 }
海关 共	闽 @
海军 树	x 攫
海陆 丰	嘲 伦
海伦 百	 κ
海伦 冲	 R
海伦 和	 M
海滩 涂	y 额
海洋学 家	v厩 a
海洋 托	v Λ
海 布	 ガ
海 出	 X
海 格	 
海 家	 a
海 涂	 额
害 出	` X
邯 邢	驼 ǚ
含有 丰	tΤ 伦
含 并	t }
寒冷 漫	HN 憨
喊 出	驰 X
旱 秋	 
焊缝 都	k_ 常
焊接 的	k钡 
焊接 等	k钡 单
焊接 点	k钡 I
焊接 缝	k钡 _
焊接 和	k钡 M
焊接 后	k钡 
焊接 史	k钡 v
焊接 是	k钡 O
焊接 由	k钡 パ
焊接 之	k钡 ぇ
焊 车	k ó
焊 成	k Θ
焊 等	k 单
焊 法	k k
焊 割	k 澄
焊 工	k u
焊 管	k 恨
焊 花	k 
焊 机	k 诀
焊 口	k f
焊 丝	k 捣
汗流浃背 地	浆yHI a
汉 发	~ o
汉 共	~ @
汉 家	~ a
汉 默	~ q
航海家 郑	璁a G
航空公司 共	瑾扭渐q @
航行 并	瑕 }
毫米 板	@μ O
好比 多	nゑ h
好比 一	nゑ @
好比 在	nゑ b
好 并	n }
好 出	n X
好 发	n o
好 丰	n 伦
好 扶	n н
好 迹	n 格
好 家	n a
好 疗	n 励
好 扑	n 汲
号 帽	腹 U
浩 发	E o
喝 采	耻 蹦
核桃 树	之 攫
核 发	 o
和风 格	M 
和平共处 的	Mキ@B 
和平共处 五	Mキ@B き
和 矮	M G
和 板	M O
和 杯	M M
和 蹦	M 论
和 并	M }
和 布	M ガ
和 采	M 蹦
和 出	M X
和 串	M 
和 缎	M v
和 额	M B
和 发	M o
和 丰	M 伦
和 扶	M н
和 格	M 
和 共	M @
和 迹	M 格
和 汲	M V
和 家	M a
和 坚	M 绊
和 敬	M q
和 佩	M ㄘ
和 扑	M 汲
和 签	M 帽
和 秋	M 
和 树	M 攫
和 苏	M 默
和 托	M Λ
和 万	M U
和 熏	M 饫
和 珀	M 
何况 还	螵p 临
何况 人	螵p H
何 家	 a
合唱指挥家 胡	X佰揣a J
合格 班	X Z
合格 被	X Q
合格 标	X 夹
合格 兵	X L
合格 并	X }
合格 不	X ぃ
合格 才	X ~
合格 的	X 
合格 给	X 倒
合格 和	X M
合格 后	X 
合格 或	X ┪
合格 零	X s
合格 率	X v
合格 农	X A
合格 品	X ~
合格 人	X H
合格 鞋	X c
合格 优	X u
合格 由	X パ
合格 者	X 
合格 这	X o
合格 证	X 谍
合家欢 聚	Xaw E
合家欢 乐	Xaw 贾
合家 俱	Xa 
合理 布	Xz ガ
合力 共	XO @
合同 并	XP }
合同 出	XP X
合同 额	XP B
合同 签	XP 帽
合在一起 共	Xb@_ @
合资 并	X戈 }
合作 并	X@ }
合 并	X }
合 苏	X 默
河北省 丰	e_ 伦
河北省 扶	e_ н
河北省 邢	e_ ǚ
河北 邢	e_ ǚ
河南省 扶	en н
河 堤	e 出
赫 布	划 ガ
鹤 发	b o
贺 婚	P B
贺 敬	P q
黑暗 共	堵t @
黑板 报	堵O 厨
黑板 上	堵O W
黑头 发	堵Y o
黑 布	堵 ガ
黑 发	堵 o
黑 格	堵 
黑 颈	堵 V
痕迹 斑	勃格 闯
痕迹 到	勃格 
很 丰	 伦
亨 默	 q
恒 丰	 伦
鸿 发	E o
洪 家	x a
洪 漫	x 憨
宏观 并	Щ[ }
宏 树	Щ 攫
红色 缎	酽 v
红十字会 共	酩Qr| @
侯 树	J 攫
后补 发	岣 o
后 背	 I
后 出	 X
后 发	 o
后 共	 @
后 签	 帽
后 树	 攫
后 苏	 默
呼声 并	In }
呼 伦	I 
葫芦 岛	脯莫 q
葫芦 的	脯莫 
葫芦 掉	脯莫 奔
葫芦 画	脯莫 e
葫芦 晒	脯莫 盼
葫芦 兴	脯莫 砍
胡 家	J a
胡 万	J U
糊涂 带	k额 a
糊涂 犯	k额 デ
糊涂 时	k额 
湖北 万	打_ U
湖 堤	打 出
弧 焊	┓ k
虎 斗	 矮
护 堤	@ 出
护 树	@ 攫
互 敬	が q
户 发	め o
户 扶	め н
户 共	め @
户 家	め a
户 签	め 帽
户 万	め U
花圈 缎	岚 v
花 杯	 M
花 格	 
华北 板	地_ O
华侨 共	地勾 @
华 背	地 I
华 并	地 }
华 丰	地 伦
华 家	地 a
华 秋	地 
华 舍	地 
华 托	地 Λ
滑雪 板	菲撤 O
滑 出	菲 X
画家 崔	ea Z
画家 的	ea 
画家 对	ea 癸
画家 范	ea S
画家 关	ea 闽
画家 韩	ea 龙
画家 和	ea M
画家 还	ea 临
画家 黄	ea 独
画家 获	ea 莉
画家 及	ea の
画家 李	ea 
画家 刘	ea B
画家 们	ea 
画家 是	ea O
画家 说	ea 弧
画家 谈	ea 酵
画家 田	ea バ
画家 同	ea P
画家 新	ea s
画家 叶	ea 腑
画家 用	ea ノ
画家 有	ea Τ
画家 于	ea _
画家 与	ea P
画家 曾	ea 纯
画家 郑	ea G
画家 之	ea ぇ
画家 周	ea P
画展 并	ei }
画 出	e X
划 出	购 X
化学家 研	て厩a 
化妆品 厂	てЗ~ t
化妆品 的	てЗ~ 
化妆品 等	てЗ~ 单
化妆品 柜	てЗ~ d
化妆品 盒	てЗ~ 舶
化妆品 检	てЗ~ 浪
化妆品 每	てЗ~ C
化妆品 外	てЗ~ ~
化妆品 业	てЗ~ ~
化妆箱 忘	てЗc а
化妆用 品	てЗノ ~
化妆 盒	てЗ 舶
化 布	て ガ
化 扶	て н
化 疗	て 励
话 并	杠 }
槐树 已	i攫 w
欢笑 和	w M
欢笑 声	w n
欢笑 著	w 帝
欢欣鼓舞 的	wY躬R 
欢迎仪式 并	w锘靓 }
欢迎 布	w ガ
欢迎 苏	w 默
欢 树	w 攫
环境 并	吏挂 }
环 杯	吏 M
环 发	吏 o
还是 出	临O X
还要 发	临n o
还在 发	临b o
还在 树	临b 攫
还 出	临 X
还 发	临 o
还 丰	临 伦
还 签	临 帽
还 托	临 Λ
缓 出	w X
换 出	传 X
换 发	传 o
患难与共 的	w螟P@ 
焕发 出	坟o X
焕发 了	坟o F
焕发 其	坟o ㄤ
焕发 著	坟o 帝
荒 并	 }
黄海 北	独 _
黄海 的	独 
黄海 和	独 M
黄海 将	独 N
黄海 南	独 n
黄河 堤	独e 出
黄金 采	独 蹦
黄杨树 苗	独法攫 ]
黄 澄	独 坚
黄 家	独 a
黄 敬	独 q
黄 帽	独 U
皇家 和	赢a M
皇家 昆	赢a 
皇家 田	赢a バ
辉 家	谨 a
恢复 并	齑_ }
回答 苏	^氮 默
回到 家	^ a
回家 吧	^a a
回家 把	^a р
回家 吃	^a Y
回家 待	^a 
回家 的	^a 
回家 都	^a 常
回家 跟	^a 蛤
回家 过	^a L
回家 和	^a M
回家 后	^a 
回家 欢	^a w
回家 换	^a 传
回家 或	^a ┪
回家 里	^a 
回家 了	^a F
回家 路	^a 隔
回家 拿	^a 
回家 去	^a h
回家 时	^a 
回家 收	^a Μ
回家 提	^a 矗
回家 跳	^a 铬
回家 贴	^a K
回家 为	^a 
回家 乡	^a m
回家 一	^a @
回家 找	^a т
回家 中	^a い
回家 赚	^a 寥
回敬 一	^q @
回 采	^ 蹦
会场 采	|初 蹦
会合 并	|X }
会见 并	|ǎ }
会见 布	|ǎ ガ
会见 格	|ǎ 
会签 订	|帽 q
会谈 并	|酵 }
会晤 并	|编 }
会晤 布	|编 ガ
会议 并	|某 }
会议 发	|某 o
会议 共	|某 @
会 背	| I
会 并	| }
会 采	| 蹦
会 出	| X
会 丰	| 伦
会 共	| @
会 敬	| q
汇出 额	蹲X B
汇 额	蹲 B
汇 丰	蹲 伦
绘画 并	酶e }
绘 出	酶 X
婚礼 的	B搂 
婚礼 就	B搂 N
婚姻 法	B k
婚姻 上	B W
婚姻 也	B ]
婚 电	B q
婚 后	B 
婚 嫁	B 儿
婚 期	B 戳
婚 丧	B 赤
婚 生	B ネ
婚 事	B ㄆ
婚 育	B |
婚 证	B 谍
浑身解数 来	待ō秆计 ㄓ
浑身 发	待ō o
混 迹	V 格
活动 并	“ }
活动 发	“ o
活动 丰	“ 伦
活动 共	“ @
活动 家	“ a
活 蹦	 论
伙伴 签	ル 帽
伙 汲	ル V
火力发电厂 煤	酩Ooqt 费
火力发电厂 之	酩Ooqt ぇ
火力发电 成	酩Ooq Θ
火力发电 站	酩Ooq 
火山爆发 的	酩szo 
火树银花 不	蹙鸹泉 ぃ
火 并	 }
获得 丰	莉o 伦
获得 婚	莉o B
获释 出	莉睦 X
获 丰	莉 伦
获 苏	莉 默
或 出	┪ X
或 发	┪ o
或 术	┪ N
霍 格	N 
货币 并	f刽 }
货物 并	f }
货物 串	f 
货物 发	f o
货物 托	f Λ
货 额	f B
货 丰	f 伦
击球 板	阑y O
击 出	阑 X
基础 并	膀娄 }
基地 共	膀a @
基 板	膀 O
机构 并	诀c }
机构 共	诀c @
机关 共	诀闽 @
机会 并	诀| }
机械化 采	诀瘪て 蹦
机械 采	诀瘪 蹦
机械 匠	诀瘪 K
迹 斑	格 闯
迹 般	格 
迹 报	格 厨
迹 不	格 ぃ
迹 成	格 Θ
迹 创	格 承
迹 催	格 妒
迹 的	格 
迹 等	格 单
迹 地	格 a
迹 都	格 常
迹 多	格 h
迹 广	格 s
迹 和	格 M
迹 后	格 
迹 汇	格 蹲
迹 及	格 の
迹 可	格 i
迹 另	格 t
迹 能	格 
迹 拍	格 ╃
迹 去	格 h
迹 却	格 o
迹 是	格 O
迹 体	格 砰
迹 相	格 
迹 象	格 H
迹 写	格 g
迹 巡	格 ǖ
迹 一	格 @
迹 已	格 w
迹 有	格 Τ
迹 于	格 _
迹 在	格 b
迹 之	格 ぇ
迹 专	格 M
迹 峥	格 W
激昂 的	E 
激昂 亢	E ぎ
激发 爱	Eo R
激发 出	Eo X
激发 斗	Eo 矮
激发 了	Eo F
激发 每	Eo C
激发 起	Eo _
激发 人	Eo H
激发 我	Eo и
激发 职	Eo 戮
讥讽 和	谜控 M
鸡蛋 并	蔓J }
鸡舍 旁	蔓 
鸡舍 送	蔓 e
绩 并	Z }
吉 并	N }
吉 布	N ガ
吉 发	N o
吉 格	N 
吉 佩	N ㄘ
吉 秋	N 
吉 翁	N 
极其 丰	伐ㄤ 伦
极其 坚	伐ㄤ 绊
极为 丰	伐 伦
极为 复	伐 _
极为 深	伐 `
籍 发	y o
集成电路 板	栋Θq隔 O
集会 并	栋| }
集结 并	栋挡 }
集体 出	栋砰 X
集团 共	栋刮 @
集中 布	栋い ガ
集资 额	栋戈 B
集 万	栋 U
及格 或	の ┪
及格 率	の v
及格 者	の 
及时 出	の X
及时 发	の o
及时 扑	の 汲
及早 并	のΝ }
及 板	の O
及 采	の 蹦
及 丰	の 伦
及 婚	の B
疾病 发	ef o
疾 疗	e 励
汲 古	V j
汲 井	V か
汲 取	V 
即将 出	YN X
即席 发	Yu o
即 发	Y o
级 共	 @
级 签	 帽
挤出 的	澜X 
挤出 机	澜X 诀
挤出 近	澜X 
挤出 一	澜X @
几 串	X 
几 家	X a
几 万	X U
脊背 和	岘I M
技术监督 等	мN菏服 单
技术监督 都	мN菏服 常
技术监督 和	мN菏服 M
技术监督 局	мN菏服 Ы
技术人员 按	мNH 
技术人员 从	мNH q
技术人员 达	мNH F
技术人员 到	мNH 
技术人员 的	мNH 
技术人员 等	мNH 单
技术人员 对	мNH 癸
技术人员 多	мNH h
技术人员 分	мNH だ
技术人员 给	мNH 倒
技术人员 和	мNH M
技术人员 举	мNH |
技术人员 来	мNH ㄓ
技术人员 说	мNH 弧
技术人员 随	мNH H
技术人员 听	мNH 钮
技术人员 下	мNH U
技术人员 先	мNH 
技术人员 要	мNH n
技术人员 也	мNH ]
技术人员 与	мNH P
技术人员 在	мNH b
技术人员 职	мNH 戮
技术人员 中	мNH い
技术援助 以	мN穿U H
技术援助 与	мN穿U P
技术员 达	мN F
技术员 当	мN 讽
技术员 的	мN 
技术员 和	мN M
技术员 们	мN 
技术员 请	мN 叫
技术员 去	мN h
技术员 挑	мN D
技术员 托	мN Λ
技术员 为	мN 
技术员 已	мN w
技术员 余	мN E
技术员 职	мN 戮
技术 拔	мN ┺
技术 班	мN Z
技术 被	мN Q
技术 比	мN ゑ
技术 笔	мN 掸
技术 标	мN 夹
技术 并	мN }
技术 不	мN ぃ
技术 部	мN 场
技术 常	мN `
技术 成	мN Θ
技术 筹	мN w
技术 出	мN X
技术 处	мN B
技术 创	мN 承
技术 粗	мN 彩
技术 催	мN 妒
技术 达	мN F
技术 档	мN 郎
技术 到	мN 
技术 的	мN 
技术 等	мN 单
技术 都	мN 常
技术 对	мN 癸
技术 多	мN h
技术 而	мN τ
技术 范	мN S
技术 防	мN 
技术 放	мN 
技术 风	мN 
技术 扶	мN н
技术 复	мN _
技术 高	мN 蔼
技术 搞	мN d
技术 给	мN 倒
技术 更	мN 
技术 攻	мN ю
技术 共	мN @
技术 规	мN W
技术 过	мN L
技术 好	мN n
技术 和	мN M
技术 很	мN 
技术 后	мN 
技术 还	мN 临
技术 汇	мN 蹲
技术 获	мN 莉
技术 或	мN ┪
技术 及	мN の
技术 级	мN 
技术 尖	мN y
技术 简	мN 虏
技术 鉴	мN 懦
技术 建	мN 
技术 将	мN N
技术 讲	мN 量
技术 节	мN `
技术 近	мN 
技术 精	мN 弘
技术 经	мN g
技术 就	мN N
技术 居	мN ~
技术 科	мN 
技术 可	мN i
技术 课	мN 揭
技术 跨	мN 阁
技术 来	мN ㄓ
技术 练	мN m
技术 两	мN ㄢ
技术 轮	мN 近
技术 论	мN 阶
技术 没	мN S
技术 门	мN 
技术 民	мN チ
技术 难	мN 螟
技术 能	мN 
技术 培	мN 蚌
技术 配	мN t
技术 去	мN h
技术 群	мN s
技术 人	мN H
技术 啥	мN 裕
技术 上	мN W
技术 时	мN 
技术 使	мN ㄏ
技术 示	мN ボ
技术 是	мN O
技术 室	мN 
技术 水	мN 
技术 司	мN q
技术 所	мN ┮
技术 台	мN x
技术 厅	мN U
技术 同	мN P
技术 推	мN 崩
技术 外	мN ~
技术 为	мN 
技术 系	мN t
技术 相	мN 
技术 向	мN V
技术 协	мN 
技术 新	мN s
技术 型	мN 
技术 性	мN ┦
技术 研	мN 
技术 也	мN ]
技术 夜	мN ]
技术 一	мN @
技术 已	мN w
技术 以	мN H
技术 引	мN ま
技术 用	мN ノ
技术 有	мN Τ
技术 又	мN S
技术 于	мN _
技术 予	мN ぉ
技术 与	мN P
技术 育	мN |
技术 园	мN 堕
技术 院	мN |
技术 跃	мN D
技术 再	мN A
技术 在	мN b
技术 则	мN h
技术 展	мN i
技术 这	мN o
技术 之	мN ぇ
技术 职	мN 戮
技术 只	мN u
技术 制	мN 
技术 中	мN い
技术 主	мN D
技术 抓	мN ъ
技术 转	мN 锣
技术 自	мN 
技术 总	мN `
技术 走	мN ǐ
技术 组	мN 舱
技术 最	мN 程
技术 作	мN @
技术 娴	мN _
技术 跻	мN E
季 丰	u 伦
季 共	u @
季 家	u a
季 托	u Λ
祭奠 的	步楚 
济 苏	蕾 默
寄 布	H ガ
寄 出	H X
寄 托	H Λ
计划草案 的	p购螽 
计划草案 时	p购螽 
计划 并	p购 }
计划 出	p购 X
计划 签	p购 帽
计量 并	pq }
计算 出	p衡 X
记者席 上	O坍u W
记者 卜	O R
记者 采	O 蹦
记者 发	O o
记者 格	O 
记者 苏	O 默
记者 万	O U
记者 翁	O 
记 格	O 
既 丰	J 伦
既 舍	J 
继承 并	~┯ }
继承 发	~┯ o
继续 并	~尿 }
继续 发	~尿 o
继 发	~ o
纪念碑 敬	雯栏O q
纪念塔 敬	雯蓝 q
纪念 树	雯 攫
夹 发	Ж o
佳节 并	ㄎ` }
家财 产	a] 玻
家产 生	a玻 ネ
家常便饭 了	a`K逗 F
家常 饭	a` 逗
家常 来	a` ㄓ
家常 又	a` S
家长 并	a }
家长 带	a a
家长 的	a 
家长 都	a 常
家长 对	a 癸
家长 给	a 倒
家长 和	a M
家长 很	a 
家长 呼	a I
家长 还	a 临
家长 会	a |
家长 讲	a 量
家长 交	a ユ
家长 经	a g
家长 开	a }
家长 来	a ㄓ
家长 里	a 
家长 忙	a Γ
家长 们	a 
家长 认	a {
家长 绒	a 党
家长 说	a 弧
家长 要	a n
家长 也	a ]
家长 有	a Τ
家长 又	a S
家长 在	a b
家法 的	ak 
家法 等	ak 单
家法 同	ak P
家法 委	ak e
家法 向	ak V
家法 一	ak @
家法 住	ak 
家家户户 按	aaめめ 
家家户户 的	aaめめ 
家家户户 都	aaめめ 常
家家户户 喝	aaめめ 耻
家家户户 还	aaめめ 临
家家户户 拉	aaめめ ┰
家家户户 用	aaめめ ノ
家家 吃	aa Y
家家 存	aa s
家家 大	aa j
家家 电	aa q
家家 都	aa 常
家家 盖	aa \
家家 粮	aa 鲁
家家 麦	aa 沉
家家 年	aa ~
家家 杀	aa 炳
家家 有	aa Τ
家家 只	aa u
家教 的	a毙 
家教 育	a毙 |
家境 略	a挂 菠
家境 穷	a挂 a
家境 谁	a挂 街
家居 县	a~ 郡
家具 带	aㄣ a
家具 的	aㄣ 
家具 都	aㄣ 常
家具 和	aㄣ M
家具 及	aㄣ の
家具 连	aㄣ s
家具 了	aㄣ F
家具 展	aㄣ i
家门 到	a 
家门 关	a 闽
家门 口	a f
家门 脸	a y
家门 前	a e
家禽 病	aV f
家禽 等	aV 单
家禽 冷	aV N
家禽 良	aV }
家禽 业	aV ~
家禽 育	aV |
家人 把	aH р
家人 不	aH ぃ
家人 除	aH 埃
家人 的	aH 
家人 多	aH h
家人 给	aH 倒
家人 共	aH @
家人 和	aH M
家人 均	aH А
家人 忙	aH Γ
家人 民	aH チ
家人 说	aH 弧
家人 抬	aH ╋
家人 围	aH 瞅
家人 一	aH @
家人 在	aH b
家人 中	aH い
家事 二	aㄆ G
家事 和	aㄆ M
家事 全	aㄆ 
家事 与	aㄆ P
家属 拜	a妮 
家属 不	a妮 ぃ
家属 从	a妮 q
家属 到	a妮 
家属 的	a妮 
家属 等	a妮 单
家属 队	a妮 钉
家属 给	a妮 倒
家属 共	a妮 @
家属 和	a妮 M
家属 户	a妮 め
家属 或	a妮 ┪
家属 及	a妮 の
家属 将	a妮 N
家属 就	a妮 N
家属 可	a妮 i
家属 来	a妮 ㄓ
家属 楼	a妮 加
家属 们	a妮 
家属 区	a妮 跋
家属 商	a妮 坝
家属 是	a妮 O
家属 说	a妮 弧
家属 送	a妮 e
家属 为	a妮 
家属 问	a妮 拜
家属 献	a妮 m
家属 向	a妮 V
家属 也	a妮 ]
家属 已	a妮 w
家属 以	a妮 H
家属 因	a妮 ]
家属 有	a妮 Τ
家属 于	a妮 _
家属 院	a妮 |
家属 在	a妮 b
家属 至	a妮 
家属 致	a妮 P
家庭教师 热	ax毙v 荐
家庭教育 的	ax毙| 
家庭教育 等	ax毙| 单
家庭教育 和	ax毙| M
家庭教育 课	ax毙| 揭
家庭教育 乱	ax毙| 睹
家庭教育 是	ax毙| O
家庭教育 象	ax毙| H
家庭教育 又	ax毙| S
家庭教育 与	ax毙| P
家庭生活 有	axネ Τ
家庭手工业 联	axもu~ p
家庭手工业 组	axもu~ 舱
家庭主妇 称	axD包 嘿
家庭主妇 和	axD包 M
家庭 被	ax Q
家庭 必	ax ゲ
家庭 便	ax K
家庭 并	ax }
家庭 成	ax Θ
家庭 储	ax x
家庭 创	ax 承
家庭 纯	ax 
家庭 从	ax q
家庭 的	ax 
家庭 等	ax 单
家庭 都	ax 常
家庭 队	ax 钉
家庭 繁	ax c
家庭 范	ax S
家庭 高	ax 蔼
家庭 关	ax 闽
家庭 过	ax L
家庭 和	ax M
家庭 化	ax て
家庭 或	ax ┪
家庭 几	ax X
家庭 将	ax N
家庭 来	ax ㄓ
家庭 联	ax p
家庭 良	ax }
家庭 内	ax ず
家庭 排	ax 逼
家庭 婆	ax C
家庭 人	ax H
家庭 是	ax O
家庭 受	ax 
家庭 送	ax e
家庭 所	ax ┮
家庭 同	ax P
家庭 脱	ax 叉
家庭 为	ax 
家庭 小	ax p
家庭 型	ax 
家庭 要	ax n
家庭 也	ax ]
家庭 用	ax ノ
家庭 有	ax Τ
家庭 育	ax |
家庭 在	ax b
家庭 中	ax い
家务事 和	a叭ㄆ M
家务 和	a叭 M
家务 活	a叭 
家务 也	a叭 ]
家乡 办	am 快
家乡 潮	am 奸
家乡 的	am 
家乡 邓	am H
家乡 夺	am 管
家乡 封	am 
家乡 过	am L
家乡 后	am 
家乡 鸡	am 蔓
家乡 喀	am 池
家乡 马	am 皑
家乡 门	am 
家乡 女	am k
家乡 亲	am 克
家乡 人	am H
家乡 扫	am 苯
家乡 时	am 
家乡 是	am O
家乡 提	am 矗
家乡 添	am K
家乡 望	am 辨
家乡 循	am `
家乡 已	am w
家乡 由	am パ
家乡 镇	am 马
家乡 正	am タ
家乡 枝	am K
家乡 之	am ぇ
家乡 做	am 暗
家小 煤	ap 费
家小 农	ap A
家信 和	aH M
家畜 的	ab 
家畜 饮	ab 都
家业 都	a~ 常
家用 的	aノ 
家用 和	aノ M
家用 人	aノ H
家用 上	aノ W
家用 于	aノ _
家喻户晓 的	a畴め惧 
家园 的	a堕 
家园 和	a堕 M
家园 制	a堕 
家政学 校	aF厩 
家族 成	a壁 Θ
家族 的	a壁 
家族 苗	a壁 ]
家祖 孙	a ]
家 阿	a 
家 艾	a 
家 把	a р
家 坝	a 膨
家 白	a フ
家 半	a b
家 办	a 快
家 堡	a 躇
家 宝	a _
家 被	a Q
家 比	a ゑ
家 标	a 夹
家 并	a }
家 不	a ぃ
家 才	a ~
家 草	a 
家 厂	a t
家 唱	a 佰
家 朝	a 绰
家 成	a Θ
家 吃	a Y
家 冲	a R
家 崇	a R
家 出	a X
家 串	a 
家 从	a q
家 凑	a 搓
家 村	a 
家 打	a ゴ
家 大	a j
家 带	a a
家 单	a 虫
家 当	a 讽
家 到	a 
家 得	a o
家 的	a 
家 登	a n
家 等	a 单
家 邓	a H
家 底	a ┏
家 地	a a
家 电	a q
家 店	a ┍
家 鼎	a 供
家 订	a q
家 丢	a メ
家 东	a F
家 栋	a 瓷
家 洞	a }
家 豆	a ě
家 都	a 常
家 独	a W
家 队	a 钉
家 多	a h
家 发	a o
家 阀	a 恢
家 范	a S
家 访	a X
家 飞	a 
家 费	a O
家 坟	a X
家 富	a I
家 赶	a 话
家 刚	a 
家 港	a 翠
家 高	a 蔼
家 各	a U
家 更	a 
家 工	a u
家 公	a そ
家 共	a @
家 沟	a 肪
家 购	a 潦
家 挂	a 本
家 关	a 闽
家 国	a 瓣
家 过	a L
家 和	a M
家 河	a e
家 亨	a 
家 宏	a Щ
家 后	a 
家 湖	a 打
家 户	a め
家 华	a 地
家 话	a 杠
家 欢	a w
家 还	a 临
家 黄	a 独
家 灰	a η
家 会	a |
家 伙	a ル
家 获	a 莉
家 基	a 膀
家 机	a 诀
家 极	a 伐
家 几	a X
家 寄	a H
家 坚	a 绊
家 简	a 虏
家 减	a 搭
家 见	a ǎ
家 建	a 
家 将	a N
家 奖	a 贱
家 角	a à
家 较	a 耕
家 杰	a 城
家 界	a 
家 近	a 
家 经	a g
家 就	a N
家 驹	a s
家 咀	a C
家 举	a |
家 距	a Z
家 俱	a 
家 骏	a @
家 勘	a 吧
家 看	a 
家 靠	a a
家 科	a 
家 口	a f
家 来	a ㄓ
家 老	a ρ
家 乐	a 贾
家 黎	a 兢
家 离	a 瞒
家 李	a 
家 里	a 
家 礼	a 搂
家 利	a Q
家 立	a ミ
家 粮	a 鲁
家 两	a ㄢ
家 聊	a 册
家 了	a F
家 岭	a 拉
家 刘	a B
家 流	a y
家 楼	a 加
家 娄	a 苞
家 路	a 隔
家 铝	a T
家 伦	a 
家 罗	a 霉
家 马	a 皑
家 买	a R
家 没	a S
家 每	a C
家 美	a 
家 们	a 
家 民	a チ
家 明	a 
家 名	a W
家 模	a 家
家 牧	a 
家 内	a ず
家 能	a 
家 年	a ~
家 扭	a п
家 农	a A
家 炮	a 
家 跑	a ]
家 泡	a w
家 配	a t
家 贫	a h
家 坡	a Y
家 其	a ㄤ
家 企	a 
家 启	a 币
家 前	a e
家 桥	a 爵
家 侨	a 勾
家 亲	a 克
家 秦	a 
家 请	a 叫
家 区	a 跋
家 圈	a 伴
家 全	a 
家 却	a o
家 仍	a ご
家 日	a ら
家 荣	a a
家 如	a p
家 三	a T
家 山	a s
家 善	a 到
家 商	a 坝
家 上	a W
家 设	a ]
家 深	a `
家 生	a ネ
家 省	a 
家 十	a Q
家 石	a ホ
家 时	a 
家 什	a ぐ
家 食	a 
家 是	a O
家 市	a カ
家 受	a 
家 书	a 
家 税	a |
家 顺	a 抖
家 说	a 弧
家 司	a q
家 四	a |
家 送	a e
家 所	a ┮
家 她	a o
家 塔	a 娥
家 台	a x
家 太	a び
家 滩	a y
家 趟	a 诫
家 特	a S
家 提	a 矗
家 体	a 砰
家 田	a バ
家 停	a 氨
家 同	a P
家 兔	a ㄟ
家 屯	a べ
家 脱	a 叉
家 外	a ~
家 万	a U
家 围	a 瞅
家 为	a 
家 卫	a 矫
家 温	a 放
家 屋	a 
家 无	a L
家 伍	a ヮ
家 喜	a 尺
家 系	a t
家 峡	a l
家 咸	a w
家 县	a 郡
家 陷	a 炒
家 祥	a 不
家 巷	a 
家 向	a V
家 校	a 
家 肖	a v
家 写	a g
家 新	a s
家 心	a み
家 姓	a m
家 休	a ヰ
家 修	a 
家 徐	a }
家 许	a \
家 学	a 厩
家 呀	a r
家 烟	a 废
家 延	a ┑
家 言	a ē
家 秧	a 
家 养	a i
家 窑	a `
家 要	a n
家 也	a ]
家 一	a @
家 已	a w
家 以	a H
家 义	a q
家 尹	a え
家 英	a ^
家 应	a 莱
家 营	a 犁
家 影	a v
家 优	a u
家 忧	a ~
家 由	a パ
家 有	a Τ
家 友	a ね
家 又	a S
家 于	a _
家 予	a ぉ
家 与	a P
家 约	a 
家 杂	a 馒
家 在	a b
家 赞	a g
家 增	a W
家 曾	a 纯
家 咋	a Q
家 詹	a 糕
家 照	a 酚
家 这	a o
家 珍	a 
家 甄	a 郝
家 争	a 
家 正	a タ
家 证	a 谍
家 支	a や
家 之	a ぇ
家 织	a 麓
家 职	a 戮
家 直	a 
家 制	a 
家 中	a い
家 种	a 贺
家 株	a 
家 朱	a Χ
家 逐	a v
家 竹	a λ
家 主	a D
家 柱	a W
家 住	a 
家 专	a M
家 赚	a 寥
家 庄	a 缠
家 卓	a 
家 自	a 
家 走	a ǐ
家 嘴	a L
家 最	a 程
家 做	a 暗
家 庵	a g
家 宕	a X
家 驷	a o
家 琪	a X
家 璇	a 姊
家 璧	a z
家 桢	a 珐
家 楹	a 翻
家 臧	a N
家 祠	a 
家 禧	a H
加工技术 的	[uмN 
加厚 堤	[p 出
加快 并	[е }
加拿大 杯	[长j M
加强 并	[j }
加强 扶	[j н
加强 扑	[j 汲
加强 苏	[j 默
加以 丰	[H 伦
加 逼	[ G
加 布	[ ガ
加 格	[ 
加 伦	[ 
加 佩	[ ㄘ
贾 格	鸽 
贾 秋	鸽 
甲板 部	ヒO 场
甲板 的	ヒO 
甲板 上	ヒO W
价格 按	基 
价格 比	基 ゑ
价格 标	基 夹
价格 补	基 干
价格 不	基 ぃ
价格 常	基 `
价格 乘	基 
价格 从	基 q
价格 大	基 j
价格 的	基 
价格 等	基 单
价格 低	基 C
价格 跌	基 ^
价格 都	基 常
价格 多	基 h
价格 而	基 τ
价格 反	基 は
价格 杠	基 
价格 高	基 蔼
价格 给	基 倒
价格 关	基 闽
价格 贵	基 Q
价格 和	基 M
价格 还	基 临
价格 回	基 ^
价格 或	基 ┪
价格 机	基 诀
价格 及	基 の
价格 急	基 
价格 计	基 p
价格 将	基 N
价格 降	基 
价格 较	基 耕
价格 仅	基 度
价格 居	基 ~
价格 每	基 C
价格 能	基 
价格 却	基 o
价格 仍	基 ご
价格 上	基 W
价格 升	基 ど
价格 时	基 
价格 同	基 P
价格 外	基 ~
价格 为	基 
价格 稳	基 铆
价格 向	基 V
价格 销	基 P
价格 要	基 n
价格 也	基 ]
价格 一	基 @
价格 已	基 w
价格 应	基 莱
价格 由	基 パ
价格 又	基 S
价格 与	基 P
价格 在	基 b
价格 则	基 h
价格 怎	基 
价格 涨	基 害
价格 折	基 ч
价格 只	基 u
价格 总	基 `
价值 共	基 @
价 签	基 帽
架构 和	[c M
架构 下	[c U
架 苏	[ 默
驾驶员 出	rp X
嫁妆 不	儿З ぃ
嫁妆 贵	儿З Q
监督 并	菏服 }
监护人 家	菏@H a
坚持不懈 大	绊ぃ居 j
坚持不懈 的	绊ぃ居 
坚持不懈 地	绊ぃ居 a
坚持不懈 开	绊ぃ居 }
坚持不懈 呢	绊ぃ居 O
坚持不懈 学	绊ぃ居 厩
坚持不懈 抓	绊ぃ居 ъ
坚持不渝 地	绊ぃ袋 a
坚持 爱	绊 R
坚持 按	绊 
坚持 巴	绊 ぺ
坚持 把	绊 р
坚持 办	绊 快
坚持 保	绊 O
坚持 并	绊 }
坚持 不	绊 ぃ
坚持 草	绊 
坚持 从	绊 q
坚持 大	绊 j
坚持 党	绊 囊
坚持 到	绊 
坚持 德	绊 w
坚持 的	绊 
坚持 登	绊 n
坚持 敌	绊 寄
坚持 定	绊 w
坚持 锻	绊 岭
坚持 对	绊 癸
坚持 多	绊 h
坚持 而	绊 τ
坚持 发	绊 o
坚持 反	绊 は
坚持 菲	绊 滇
坚持 俯	绊 
坚持 改	绊 э
坚持 干	绊 F
坚持 高	绊 蔼
坚持 搞	绊 d
坚持 各	绊 U
坚持 管	绊 恨
坚持 和	绊 M
坚持 换	绊 传
坚持 己	绊 v
坚持 将	绊 N
坚持 讲	绊 量
坚持 紧	绊 候
坚持 开	绊 }
坚持 看	绊 
坚持 刻	绊 ㄨ
坚持 苦	绊 W
坚持 雷	绊 p
坚持 立	绊 ミ
坚持 粮	绊 鲁
坚持 两	绊 ㄢ
坚持 了	绊 F
坚持 马	绊 皑
坚持 吗	绊 盾
坚持 每	绊 C
坚持 面	绊 
坚持 南	绊 n
坚持 平	绊 キ
坚持 其	绊 ㄤ
坚持 骑	绊 M
坚持 求	绊 D
坚持 取	绊 
坚持 让	绊 琵
坚持 山	绊 s
坚持 上	绊 W
坚持 少	绊 ぶ
坚持 设	绊 ]
坚持 十	绊 Q
坚持 什	绊 ぐ
坚持 殊	绊 
坚持 说	绊 弧
坚持 四	绊 |
坚持 送	绊 e
坚持 同	绊 P
坚持 统	绊 参
坚持 违	绊 H
坚持 为	绊 
坚持 我	绊 и
坚持 无	绊 L
坚持 西	绊 
坚持 下	绊 U
坚持 向	绊 V
坚持 小	绊 p
坚持 学	绊 厩
坚持 巡	绊 ǖ
坚持 要	绊 n
坚持 业	绊 ~
坚持 一	绊 @
坚持 依	绊 ㄌ
坚持 已	绊 w
坚持 以	绊 H
坚持 用	绊 ノ
坚持 优	绊 u
坚持 由	绊 パ
坚持 油	绊 o
坚持 有	绊 Τ
坚持 与	绊 P
坚持 原	绊 
坚持 栽	绊 
坚持 在	绊 b
坚持 择	绊 拒
坚持 找	绊 т
坚持 这	绊 o
坚持 政	绊 F
坚持 支	绊 や
坚持 执	绊 磅
坚持 只	绊 u
坚持 中	绊 い
坚持 种	绊 贺
坚持 著	绊 帝
坚持 住	绊 
坚持 驻	绊 n
坚持 抓	绊 ъ
坚持 专	绊 M
坚持 自	绊 
坚持 走	绊 ǐ
坚持 做	绊 暗
坚定不移 的	绊wぃ簿 
坚定不移 地	绊wぃ簿 a
坚定不移 和	绊wぃ簿 M
坚定不移 走	绊wぃ簿 ǐ
坚定 党	绊w 囊
坚定 的	绊w 
坚定 地	绊w a
坚定 对	绊w 癸
坚定 而	绊w τ
坚定 跟	绊w 蛤
坚定 和	绊w M
坚定 了	绊w F
坚定 性	绊w ┦
坚定 走	绊w ǐ
坚固 的	绊T 
坚固 又	绊T S
坚决 按	绊M 
坚决 不	绊M ぃ
坚决 查	绊M d
坚决 从	绊M q
坚决 的	绊M 
坚决 地	绊M a
坚决 对	绊M 癸
坚决 搞	绊M d
坚决 和	绊M M
坚决 合	绊M X
坚决 纠	绊M 
坚决 开	绊M }
坚决 了	绊M F
坚决 刹	绊M b
坚决 同	绊M P
坚决 依	绊M ㄌ
坚决 予	绊M ぉ
坚决 与	绊M P
坚决 赞	绊M g
坚韧不拔 的	绊洞ぃ┺ 
坚韧 的	绊洞 
坚实 的	绊龟 
坚实 纽	绊龟 
坚实 严	绊龟 Y
坚守 大	绊u j
坚守 在	绊u b
坚守 主	绊u D
坚挺 的	绊 
坚挺 仅	绊 度
坚信 党	绊H 囊
坚信 马	绊H 皑
坚信 这	绊H o
坚毅 的	绊驾 
坚硬 的	绊w 
坚硬 毛	绊w を
坚 白	绊 フ
坚 必	绊 ゲ
坚 参	绊 把
坚 等	绊 单
坚 和	绊 M
坚 还	绊 临
坚 科	绊 
坚 强	绊 j
坚 胜	绊 秤
坚 说	绊 弧
坚 稳	绊 铆
坚 在	绊 b
坚 赞	绊 g
坚 志	绊 в
尖端技术 都	y狠мN 常
尖利 的	yQ 
间 共	丁 @
间 签	丁 帽
兼 并	 }
兼 出	 X
兼 发	 o
兼 苏	 默
肩膀 托	踊H Λ
肩 背	 I
肩 并	 }
肩 斗	 矮
检查 并	浪d }
检查 出	浪d X
检讨 发	浪Q o
检验 共	浪喷 @
检 出	浪 X
柬埔寨 并	ZH闺 }
柬埔寨 出	ZH闺 X
剪纸艺术 家	芭让莱N a
剪 发	芭 o
减少 并	搭ぶ }
减少 采	搭ぶ 蹦
减刑 出	搭D X
减 发	搭 o
减 万	搭 U
鉴 家	懦 a
见人 家	ǎH a
件 并	ン }
件 共	ン @
件 家	ン a
健康 杯	胺d M
健康 丰	胺d 伦
剑 出	C X
剑 共	C @
剑 秋	C 
建立 并	廿 }
建立 扶	廿 н
建立 坚	廿 绊
建设 并	爻] }
建设 布	爻] ガ
建设 共	爻] @
建设 坚	爻] 绊
建树 的	鼐 
建树 后	鼐 
建树 盘	鼐 L
建校 舍	禺 
建议 并	啬 }
建议 格	啬 
建 并	 }
建 万	 U
将 出	N X
将 丰	N 伦
将 扶	N н
将 格	N 
将 家	N a
将 签	N 帽
将 苏	N 默
江苏 八	磕 K
江苏 城	磕 
江苏 的	磕 
江苏 等	磕 单
江苏 调	磕 秸
江苏 东	磕 F
江苏 队	磕 钉
江苏 对	磕 癸
江苏 二	磕 G
江苏 赴	磕 u
江苏 高	磕 蔼
江苏 搞	磕 d
江苏 各	磕 U
江苏 古	磕 j
江苏 和	磕 M
江苏 淮	磕 a
江苏 及	磕 の
江苏 加	磕 [
江苏 江	磕 
江苏 京	磕 ㄊ
江苏 来	磕 ㄓ
江苏 连	磕 s
江苏 名	磕 W
江苏 南	磕 n
江苏 男	磕 k
江苏 沛	磕 K
江苏 庆	磕 y
江苏 全	磕 
江苏 人	磕 H
江苏 省	磕 
江苏 是	磕 O
江苏 水	磕 
江苏 素	磕 
江苏 台	磕 x
江苏 泰	磕 
江苏 铜	磕 簧
江苏 团	磕 刮
江苏 王	磕 
江苏 盐	磕 Q
江苏 一	磕 @
江苏 仪	磕 祸
江苏 已	磕 w
江苏 以	磕 H
江苏 余	磕 E
江苏 在	磕 b
江苏 张	磕 i
江苏 邳	磕 椭
江苏 沭	磕 条
江苏 泗	磕 r
江苏 溧	磕 诽
江 杯	 M
江 堤	 出
江 格	 
江 漫	 憨
疆 共	忙 @
奖金 额	贱 B
奖金 发	贱 o
奖励 扶	贱y н
奖牌 并	贱P }
奖 杯	贱 M
奖 并	贱 }
奖 出	贱 X
讲座 共	量y @
讲 出	量 X
讲 婚	量 B
匠 茅	K T
降低 并	哀C }
降低 发	哀C o
降生 到	哎 
降生 的	哎 
降生 和	哎 M
降雨量 大	矮Bq j
降雨量 多	矮Bq h
降雨量 将	矮Bq N
降雨量 仅	矮Bq 度
降雨量 小	矮Bq p
降雨量 有	矮Bq Τ
降雨量 在	矮Bq b
降雨 的	矮B 
降雨 防	矮B 
降雨 和	矮B M
降雨 夹	矮B Ж
降雨 竟	矮B 澈
降雨 净	矮B b
降雨 雪	矮B 撤
胶布 是	溅ガ O
胶布 在	溅ガ b
胶布 粘	溅ガ 诌
交给 苏	ユ倒 默
交换意见 并	ユ传Nǎ }
交流 并	ユy }
交流 共	ユy @
交易会 共	ユ龇| @
交易 额	ユ B
交 出	ユ X
郊区 共	グ @
郊 万	 U
浇 出	煎 X
浇 树	煎 攫
脚板 走	}O ǐ
脚 扑	} 汲
角膜病 残	à饯f 摧
角膜病 致	à饯f P
角 帽	à U
饺子 出	诲l X
缴 额	煤 B
剿 共	断 @
教练 出	毙m X
教练 共	毙m @
教育家 的	毙|a 
教育家 黄	毙|a 独
教育家 马	毙|a 皑
教育家 张	毙|a i
教育家 朱	毙|a Χ
教育 婚	毙| B
教 扶	毙 н
较量 并	耕q }
较 丰	耕 伦
叫嚣 不	s嫩 ぃ
叫 板	s O
叫 出	s X
窖 杯	耽 M
揭发 和	处o M
揭发 原	处o 
揭开 苏	处} 默
揭露 并	处S }
揭示 出	处ボ X
揭 出	处 X
接待 并	钡 }
接到 布	钡 ガ
接连 扑	钡s 汲
接球 出	钡y X
接受 并	钡 }
接下来 的	钡Uㄓ 
接线 员	钡u 
接 并	钡 }
接 出	钡 X
接 发	钡 o
接 树	钡 攫
皆 佩	 ㄘ
皆 树	 攫
街道 串	刁D 
街道 敬	刁D q
街头 布	刁Y ガ
街 串	刁 
阶段 按	顶q 
阶段 成	顶q Θ
阶段 从	顶q q
阶段 的	顶q 
阶段 对	顶q 癸
阶段 和	顶q M
阶段 后	顶q 
阶段 较	顶q 耕
阶段 内	顶q ず
阶段 时	顶q 
阶段 所	顶q ┮
阶段 踢	顶q 金
阶段 为	顶q 
阶段 性	顶q ┦
阶段 也	顶q ]
阶段 在	顶q b
阶段 只	顶q u
阶段 转	顶q 锣
阶级斗争 的	顶虐 
阶级斗争 激	顶虐 E
阶级斗争 在	顶虐 b
阶级斗争 中	顶虐 い
节目 丰	`ヘ 伦
节日 树	`ら 攫
节 共	` @
节 万	` U
桔 发	 o
桔 树	 攫
杰出 成	城X Θ
杰出 的	城X 
杰出 女	城X k
捷 共	倍 @
捷 苏	倍 默
结果 并	挡G }
结果 树	挡G 攫
结合 发	挡X o
结合 树	挡X 攫
结婚前 我	挡Be и
结婚 的	挡B 
结婚 和	挡B M
结婚 花	挡B 
结婚 了	挡B F
结婚 没	挡B S
结婚 生	挡B ネ
结婚 时	挡B 
结婚 送	挡B e
结婚 准	挡B 
结束 并	挡 }
结束 苏	挡 默
结扎 术	挡蚕 N
结 采	挡 蹦
结 出	挡 X
解放军 共	秆癍x @
解放 并	秆 }
解决 出	秆M X
解散 并	秆床 }
解释 奥	秆睦 而
解释 不	秆睦 ぃ
解释 此	秆睦 
解释 得	秆睦 o
解释 的	秆睦 
解释 各	秆睦 U
解释 和	秆睦 M
解释 后	秆睦 
解释 或	秆睦 ┪
解释 了	秆睦 F
解释 器	秆睦 竟
解释 热	秆睦 荐
解释 时	秆睦 
解释 说	秆睦 弧
解释 他	秆睦 L
解释 为	秆睦 
解释 我	秆睦 и
解释 性	秆睦 ┦
解释 也	秆睦 ]
解释 这	秆睦 o
解释 著	秆睦 帝
解 出	秆 X
解 家	秆 a
解 敬	秆 q
解 苏	秆 默
姐 家	j a
界 敬	 q
界 签	 帽
介 布	ざ ガ
届 杯	 M
届 格	 
金额 百	髅B κ
金额 达	髅B F
金额 仅	髅B 度
金额 近	髅B 
金额 居	髅B ~
金额 两	髅B ㄢ
金额 留	髅B d
金额 仍	髅B ご
金额 为	髅B 
金额 已	髅B w
金额 逾	髅B O
金额 约	髅B 
金额 占	髅B 
金额 中	髅B い
金额 逐	髅B v
金牌 并	鞯P }
金融界 的	骺默 
金融界 优	骺默 u
金融界 有	骺默 Τ
金融界 与	骺默 P
金融 家	骺 a
金属 涂	髂 额
金 杯	 M
金 发	 o
金 家	 a
金 秋	 
金 术	 N
金 万	 U
今后 签	さ 帽
今年 出	さ~ X
今年 丰	さ~ 伦
今年 共	さ~ @
今天 并	さぱ }
今天 出	さぱ X
今天 丰	さぱ 伦
今天 共	さぱ @
今天 签	さぱ 帽
今晚 出	さ边 X
今晚 共	さ边 @
今 秋	さ 
紧凑 丰	候搓 伦
紧急状态 并	候妾A }
紧接著 出	候钡帝 X
紧接 发	候钡 o
紧锣密鼓 地	候rK躬 a
紧身 裤	候ō 壳
紧张 的	候i 
紧张 等	候i 单
紧张 地	候i a
紧张 冬	候i V
紧张 动	候i 笆
紧张 而	候i τ
紧张 关	候i 闽
紧张 喊	候i 驰
紧张 和	候i M
紧张 了	候i F
紧张 美	候i 
紧张 却	候i o
紧张 时	候i 
紧张 什	候i ぐ
紧张 停	候i 氨
紧张 心	候i み
紧张 与	候i P
紧张 之	候i ぇ
紧张 中	候i い
紧张 准	候i 
紧 逼	候 G
进出口贸易 的	iXfT 
进出口贸易 中	iXfT い
进出口贸易 总	iXfT `
进出口商 会	iXf坝 |
进出口商 品	iXf坝 ~
进出口业 务	iXf~ 叭
进出口银行 和	iXf蝗 M
进出口银行 为	iXf蝗 
进出口 部	iXf 场
进出口 插	iXf 础
进出口 处	iXf B
进出口 额	iXf B
进出口 共	iXf @
进出口 国	iXf 瓣
进出口 和	iXf M
进出口 均	iXf А
进出口 量	iXf q
进出口 权	iXf v
进出口 总	iXf `
进出 厂	iX t
进出 港	iX 翠
进出 海	iX 
进出 境	iX 挂
进出 品	iX ~
进出 站	iX 
进口 并	if }
进口 额	if B
进入 丰	iJ 伦
进行 并	i }
进行 共	i @
进行 家	i a
进一步 发	i@B o
进一步 丰	i@B 伦
进展 并	ii }
进 斗	i 矮
进 发	i o
进 敬	i q
进 万	i U
晋 签	 帽
禁令 并	TO }
禁止 并	Tゎ }
近况 甚	癃p 
近况 时	癃p 
近年来 扶	瘭~ㄓ н
近年来 共	瘭~ㄓ @
近期 出	翊 X
近期 疗	翊 励
近视眼 发	竦泊 o
近 万	 U
晶 格	垂 
京都 高	ㄊ常 蔼
京 发	ㄊ o
京 丰	ㄊ 伦
京 格	ㄊ 
京 家	ㄊ a
京 伦	ㄊ 
精雕细琢 的	弘J灿Z 
精简 并	弘虏 }
精神病 疗	弘f 励
精神焕发 出	弘坟o X
精神焕发 了	弘坟o F
精选 出	弘匡 X
精 采	弘 蹦
经常 背	g` I
经过 漫	gL 憨
经过 万	gL U
经济部长 默	g蕾场 q
经济复苏 的	g蕾_默 
经济学家 陈	g蕾厩a 朝
经济学家 对	g蕾厩a 癸
经济学家 关	g蕾厩a 闽
经济学家 和	g蕾厩a M
经济学家 还	g蕾厩a 临
经济学家 蒋	g蕾厩a 奖
经济学家 卡	g蕾厩a d
经济学家 克	g蕾厩a J
经济学家 罗	g蕾厩a 霉
经济学家 们	g蕾厩a 
经济学家 却	g蕾厩a o
经济学家 仍	g蕾厩a ご
经济学家 斯	g蕾厩a 吹
经济学家 索	g蕾厩a 
经济学家 中	g蕾厩a い
经济 并	g蕾 }
经济 布	g蕾 ガ
经济 家	g蕾 a
经理 格	gz 
经历 并	g菌 }
经验 并	g喷 }
经验 丰	g喷 伦
经营 并	g犁 }
经营 布	g犁 ガ
经营 额	g犁 B
井 况	か p
警 并	牡 }
警 佩	牡 ㄘ
景况 喜	春p 尺
景 扶	春 н
颈部 长	V场 
颈部 的	V场 
颈部 受	V场 
颈椎 病	V凑 f
颈椎 骨	V凑 癌
颈 和	V M
颈 鹤	V b
颈 上	V W
颈 下	V U
境况 和	挂p M
敬爱 的	qR 
敬酒 的	qs 
敬佩 的	qㄘ 
敬佩 和	qㄘ M
敬佩 又	qㄘ S
敬佩 这	qㄘ o
敬佩 之	qㄘ ぇ
敬仰 雷	qヵ p
敬仰 他	qヵ L
敬意 把	qN р
敬意 和	qN M
敬重 和	q M
敬 边	q 娩
敬 标	q 夹
敬 才	q ~
敬 党	q 囊
敬 德	q w
敬 的	q 
敬 地	q a
敬 对	q 癸
敬 佛	q 
敬 还	q 临
敬 久	q [
敬 老	q ρ
敬 了	q F
敬 慕	q }
敬 农	q A
敬 如	q p
敬 三	q T
敬 为	q 
敬 文	q ゅ
敬 先	q 
敬 贤	q 藉
敬 献	q m
敬 修	q 
敬 延	q ┑
敬 业	q ~
敬 一	q @
敬 宜	q y
敬 以	q H
敬 在	q b
敬 之	q ぇ
敬 柱	q W
敬 梓	q 标
敬 焘	q v
竞技场 以	vм初 H
竞赛 共	v辽 @
竞选 并	v匡 }
竞 发	v o
净 额	b B
窘困 并	~x }
窘 况	~ p
久别重逢 的	[O{ 
久 敬	[ q
九龙 杯	Es M
九 家	E a
酒杯 碰	sM I
酒杯 说	sM 弧
酒家 的	sa 
酒家 将	sa N
酒家 能	sa 
救出 藏	毕X 旅
救出 的	毕X 
救出 了	毕X F
救出 溺	毕X 纺
救出 因	毕X ]
救出 壮	毕X Ё
救济 扶	毕蕾 н
救死扶伤 的	毕骇叨 
救灾 扶	毕a н
舅父 家	袱 a
就得 出	No X
就得 扑	No 汲
就近 万	N U
就是 出	NO X
就是 家	NO a
就是 舍	NO 
就业 并	N~ }
就 背	N I
就 逼	N G
就 出	N X
就 发	N o
就 签	N 帽
就 苏	N 默
鞠 秋	六 
拘留 并	╇d }
居家 中	~a い
居民 家	~チ a
居先 的	~ 
居 万	~ U
菊 家	碘 a
局部地区 的	Ы场a跋 
局部地区 有	Ы场a跋 Τ
局部麻醉 下	Ы场陈K U
局部战争 是	Ы场驹 O
局部 城	Ы场 
局部 的	Ы场 
局部 滑	Ы场 菲
局部 或	Ы场 ┪
局部 看	Ы场 
局部 网	Ы场 呼
局部 性	Ы场 ┦
局部 有	Ы场 Τ
局长 格	Ы 
局长 签	Ы 帽
局长 舍	Ы 
局长 邢	Ы ǚ
局面 出	Ы X
局势 并	Ы墩 }
局 出	Ы X
局 共	Ы @
局 敬	Ы q
局 签	Ы 帽
局 苏	Ы 默
局 万	Ы U
举杯 畅	|M Z
举杯 互	|M が
举出 了	|X F
举出 这	|X o
举家 逛	|a }
举家 回	|a ^
举家 在	|a b
举行 苏	| 默
拒绝 扶	┶荡 н
拒 出	┶ X
据 并	沮 }
据 布	沮 ガ
据 采	沮 蹦
据 佩	沮 ㄘ
巨额 存	エB s
巨额 的	エB 
巨额 债	エB 杜
巨头 默	エY q
巨 铲	エ 藐
巨 匠	エ K
具体 布	ㄣ砰 ガ
具有 丰	ㄣΤ 伦
具有 坚	ㄣΤ 绊
距 采	Z 蹦
距 树	Z 攫
俱乐部 杯	鸭殖 M
俱 杯	 M
剧作家 关	@@a 闽
剧作家 赫	@@a 划
剧作家 沙	@@a F
捐款 额	酱 B
捐 出	 X
觉得 并	谋o }
决定 并	Mw }
决心 发	Mみ o
决议草案 等	M某螽 单
决议草案 供	M某螽 ㄑ
决议草案 和	M某螽 M
决议草案 呼	M某螽 I
决议草案 说	M某螽 弧
决议草案 中	M某螽 い
决议 并	M某 }
决 出	M X
决 堤	M 出
绝不 背	荡ぃ I
绝对 额	荡癸 B
绝 迹	荡 格
绝 伦	荡 
军备竞赛 并	x称v辽 }
军队 并	x钉 }
军方 共	xよ @
军民 并	xチ }
军民 发	xチ o
军民 共	xチ @
军区 并	x跋 }
军区 共	x跋 @
军区 树	x跋 攫
军事 家	xㄆ a
军 并	x }
军 共	x @
军 家	x a
君 杯	g M
君 出	g X
君 秋	g 
俊 树	T 攫
喀布尔 以	池ガ焊 H
喀布尔 重	池ガ焊 
喀 喇	池 斥
卡 布	d ガ
卡 伦	d 
卡 秋	d 
卡 翁	d 
开采 的	}蹦 
开采 等	}蹦 单
开采 复	}蹦 _
开采 高	}蹦 蔼
开采 和	}蹦 M
开采 或	}蹦 ┪
开采 磷	}蹦 C
开采 那	}蹦 ê
开采 难	}蹦 螟
开采 期	}蹦 戳
开采 前	}蹦 e
开采 区	}蹦 跋
开采 权	}蹦 v
开采 深	}蹦 `
开采 史	}蹦 v
开采 外	}蹦 ~
开采 一	}蹦 @
开采 已	}蹦 w
开诚布公 的	}港ガそ 
开除 出	}埃 X
开发银行 和	}o蝗 M
开发 办	}o 快
开发 宝	}o _
开发 报	}o 厨
开发 贝	}o ī
开发 并	}o }
开发 不	}o ぃ
开发 成	}o Θ
开发 持	}o 
开发 赤	}o í
开发 出	}o X
开发 大	}o j
开发 当	}o 讽
开发 得	}o o
开发 的	}o 
开发 等	}o 单
开发 点	}o I
开发 都	}o 常
开发 对	}o 癸
开发 吨	}o 痉
开发 而	}o τ
开发 范	}o S
开发 方	}o よ
开发 费	}o O
开发 风	}o 
开发 扶	}o н
开发 福	}o 褐
开发 复	}o _
开发 高	}o 蔼
开发 给	}o 倒
开发 光	}o 
开发 海	}o 
开发 和	}o M
开发 红	}o 
开发 后	}o 
开发 荒	}o 
开发 机	}o 诀
开发 及	}o の
开发 既	}o J
开发 见	}o ǎ
开发 建	}o 
开发 将	}o N
开发 较	}o 耕
开发 结	}o 挡
开发 近	}o 
开发 就	}o N
开发 可	}o i
开发 矿	}o q
开发 来	}o ㄓ
开发 李	}o 
开发 量	}o q
开发 了	}o F
开发 列	}o C
开发 吕	}o f
开发 旅	}o 
开发 马	}o 皑
开发 民	}o チ
开发 名	}o W
开发 摸	}o N
开发 南	}o n
开发 脑	}o 福
开发 年	}o ~
开发 怒	}o 
开发 攀	}o k
开发 品	}o ~
开发 浦	}o 
开发 前	}o e
开发 区	}o 跋
开发 全	}o 
开发 热	}o 荐
开发 沙	}o F
开发 山	}o s
开发 上	}o W
开发 深	}o `
开发 是	}o O
开发 适	}o A
开发 试	}o 刚
开发 署	}o p
开发 水	}o 
开发 司	}o q
开发 所	}o ┮
开发 塔	}o 娥
开发 塘	}o 俄
开发 同	}o P
开发 投	}o щ
开发 屯	}o べ
开发 外	}o ~
开发 完	}o Ч
开发 为	}o 
开发 我	}o и
开发 五	}o き
开发 稀	}o }
开发 小	}o p
开发 效	}o 
开发 新	}o s
开发 型	}o 
开发 性	}o ┦
开发 烟	}o 废
开发 盐	}o Q
开发 研	}o 
开发 要	}o n
开发 也	}o ]
开发 业	}o ~
开发 一	}o @
开发 已	}o w
开发 以	}o H
开发 有	}o Τ
开发 于	}o _
开发 与	}o P
开发 运	}o B
开发 在	}o b
开发 造	}o y
开发 这	}o o
开发 中	}o い
开发 种	}o 贺
开发 株	}o 
开发 竹	}o λ
开发 专	}o M
开发 转	}o 锣
开发 准	}o 
开发 总	}o `
开发 做	}o 暗
开花 万	} U
开会 并	}| }
开矿 并	}q }
开幕式 并	}辊Α }
开枪 并	}j }
开始 并	}l }
开始 出	}l X
开始 发	}l o
开始 佩	}l ㄘ
开始 签	}l 帽
开拓 杯	}┹ M
开 背	} I
开 出	} X
刊出 过	ZX L
勘察 并	吧诡 }
坎 伦	Б 
砍 树	 攫
看出 来	荪X ㄓ
看出 了	荪X F
看出 她	荪X o
看出 我	荪X и
看待 发	莴 o
看得出 你	荼oX A
看起来 很	莅_ㄓ 
看起来 叫	莅_ㄓ s
看起来 也	莅_ㄓ ]
看做 是	莅 O
看 漫	 憨
康复 出	d_ X
康 采	d 蹦
抗战 并	к驹 }
考察 并	σ诡 }
考古学家 坎	σj厩a Б
考古学家 来	σj厩a ㄓ
考古学家 说	σj厩a 弧
考古学家 在	σj厩a b
考据 家	σ沮 a
考 伦	σ 
靠 逼	a G
靠 出	a X
棵 树	词 攫
科长 坚	飒 绊
科技 扶	歆 н
科威特 并	飓炉S }
科威特 出	飓炉S X
科威特 共	飓炉S @
科学家 把	炀钱a р
科学家 陈	炀钱a 朝
科学家 的	炀钱a 
科学家 对	炀钱a 癸
科学家 共	炀钱a @
科学家 和	炀钱a M
科学家 何	炀钱a 
科学家 还	炀钱a 临
科学家 获	炀钱a 莉
科学家 加	炀钱a [
科学家 将	炀钱a N
科学家 近	炀钱a 
科学家 来	炀钱a ㄓ
科学家 亮	炀钱a G
科学家 马	炀钱a 皑
科学家 们	炀钱a 
科学家 普	炀钱a 炊
科学家 钱	炀钱a 窥
科学家 秦	炀钱a 
科学家 若	炀钱a Y
科学家 使	炀钱a ㄏ
科学家 是	炀钱a O
科学家 说	炀钱a 弧
科学家 汪	炀钱a L
科学家 为	炀钱a 
科学家 休	炀钱a ヰ
科学家 研	炀钱a 
科学家 一	炀钱a @
科学家 以	炀钱a H
科学家 有	炀钱a Τ
科学家 又	炀钱a S
科学家 在	炀钱a b
科学家 只	炀钱a u
科学家 作	炀钱a @
科 伦	 
科 托	 Λ
壳 出	催 X
可敬 的	iq 
可口可乐 杯	ifi贾 M
可能 出	i X
可行 并	i }
可以说是 发	iH弧O o
可以 出	iH X
可预测 的	iw代 
可 背	i I
可 采	i 蹦
可 出	i X
可 发	i o
可 佩	i ㄘ
克制 并	J }
克 布	J ガ
克 出	J X
克 格	J 
克 家	J a
克 伦	J 
克 签	J 帽
克 苏	J 默
克 托	J Λ
刻 家	ㄨ a
客家人 的	犬aH 
客家人 南	犬aH n
客家 话	犬a 杠
客家 乡	犬a m
客家 语	犬a y
客家 祖	犬a 
客人 敬	趣H q
客舍 等	泉 单
课程 并	揭{ }
课堂 上	揭绑 W
课题 摆	揭D \
课题 被	揭D Q
课题 成	揭D Θ
课题 达	揭D F
课题 的	揭D 
课题 等	揭D 单
课题 共	揭D @
课题 和	揭D M
课题 后	揭D 
课题 还	揭D 临
课题 近	揭D 
课题 经	揭D g
课题 来	揭D ㄓ
课题 列	揭D C
课题 使	揭D ㄏ
课题 是	揭D O
课题 数	揭D 计
课题 外	揭D ~
课题 已	揭D w
课题 约	揭D 
课题 之	揭D ぇ
课题 组	揭D 舱
肯定 苏	蜘w 默
坑 采	| 蹦
空白 并	钮 }
空出 的	钮X 
恐 共	 @
控制板 出	北瞠O X
抠 出	徉 X
口 扶	f н
扣帽子 的	ΙUl 
扣 发	Ι o
寇 家	F a
枯 树	\ 攫
苦斗 才	W矮 ~
苦恼 了	Wo F
库伦 乡	w m
库 出	w X
库 苏	w 默
裤带 子	壳a l
裤管 上	壳恨 W
裤腿 一	壳L @
裤子 和	壳l M
裤 的	壳 
裤 红	壳 
裤 去	壳 h
裤 上	壳 W
裤 新	壳 s
垮 出	 X
跨 出	阁 X
块 板	遏 O
快板 等	еO 单
快板 书	еO 
快 出	е X
快 签	е 帽
款额 就	蹿B N
匡 扶	J н
矿工 杯	qu M
矿工 家	qu a
矿山 发	qs o
矿 采	q 蹦
矿 共	q @
况且 他	pB L
况 及	p の
况 速	p t
亏损 额	莲l B
奎 家	 a
困难 并	x螟 }
拉出 来	┰X ㄓ
拉出 狱	┰X 夯
拉起 了	┰_ F
拉萨 发	┰履 o
拉 杯	┰ M
拉 并	┰ }
拉 布	┰ ガ
拉 发	┰ o
拉 格	┰ 
拉 家	┰ a
拉 托	┰ Λ
喇叭声 由	斥zn パ
喇叭 口	斥z f
喇叭 里	斥z 
喇叭 一	斥z @
喇叭 则	斥z h
喇嘛 的	斥估 
喇嘛 甸	斥估 l
喇嘛 们	斥估 
喇嘛 虽	斥估 瘤
喇嘛 鞋	斥估 c
喇 昆	斥 
喇 沁	斥 G
腊梅 就	镁宾 N
腊梅 怒	镁宾 
腊梅 原	镁宾 
莱 昂	弟 
莱 伦	弟 
莱 舍	弟 
来到 采	ㄓ 蹦
来到 家	ㄓ a
来到 敬	ㄓ q
来到 邢	ㄓ ǚ
来源 并	ㄓ方 }
来 出	ㄓ X
来 发	ㄓ o
来 共	ㄓ @
来 家	ㄓ a
来 签	ㄓ 帽
来 苏	ㄓ 默
赖 家	苦 a
蓝 裤	屡 壳
兰 布	孽 ガ
兰 格	孽 
兰 家	孽 a
兰 裤	孽 壳
兰 树	孽 攫
缆 布	l ガ
滥 采	垒 蹦
滥 发	垒 o
琅 杯	w M
狼 共	T @
廊 发	Y o
朗 格	 
朗 伦	 
浪漫 主	龊 D
劳动 共	骋笆 @
劳工部长 的	骋u场 
劳工部长 多	骋u场 h
劳工部长 和	骋u场 M
劳力 杯	骋O M
劳力 出	骋O X
劳伦斯 利	骋鄞 Q
劳 伦	骋 
老百姓 出	ρκm X
老百姓 家	ρκm a
老板 的	ρO 
老板 们	ρO 
老板 王	ρO 
老糊涂 了	ρk额 F
老家 办	ρa 快
老家 呆	ρa b
老家 到	ρa 
老家 的	ρa 
老家 给	ρa 倒
老家 过	ρa L
老家 和	ρa M
老家 临	ρa {
老家 新	ρa s
老家 在	ρa b
老人 背	ρH I
老人 出	ρH X
老人 发	ρH o
老人 扶	ρH н
老人 家	ρH a
老式 苏	ρΑ 默
老天爷 发	ρぱ份 o
老翁 勇	ρ i
老乡 家	ρm a
老 扶	ρ н
老 敬	ρ q
老 舍	ρ 
老 树	ρ 攫
老 邢	ρ ǚ
涝 秋	妩 
勒 布	扒 ガ
勒 格	扒 
勒 苏	扒 默
勒 托	扒 Λ
乐 杯	贾 M
乐 万	贾 U
雷 格	p 
雷 默	p q
雷 托	p Λ
磊 托	U Λ
累计 额	仓p B
累计 共	仓p @
累计 签	仓p 帽
累 并	仓 }
累 额	仓 B
累 共	仓 @
类型 共	摸 @
类 丰	摸 伦
类 共	摸 @
泪 扑	\ 汲
楞 板	帆 O
冷冻 术	N N
冷气 逼	N G
冷轧 板	N O
梨 树	冰 攫
黎 共	兢 @
离开 敬	瞒} q
离乡背井 的	瞒mIか 
离 采	瞒 蹦
离 家	瞒 a
离 苏	瞒 默
离 弦	瞒 ┒
理论家 水	z阶a 
理事会主席 阿	zㄆ|Du 
理事会主席 等	zㄆ|Du 单
理事会主席 法	zㄆ|Du k
理事会主席 后	zㄆ|Du 
理事会主席 李	zㄆ|Du 
理事会主席 松	zㄆ|Du P
理事会主席 苏	zㄆ|Du 默
理事会主席 沃	zㄆ|Du U
理事会主席 谢	zㄆ|Du 谅
理事会主席 雅	zㄆ|Du 懂
理 出	z X
理 发	z o
理 疗	z 励
理 佩	z ㄘ
李 发	 o
李 家	 a
李 敬	 q
李 默	 q
李 秋	 
李 苏	 默
李 万	 U
李 溪	 匪
里昂 的	僵 
里昂 等	僵 单
里昂 信	僵 H
里昂 制	僵 
里长 出	姜 X
里拉 布	僵 ガ
里 杯	 M
里 并	 }
里 布	 ガ
里 采	 蹦
里 出	 X
里 串	 
里 发	 o
里 格	 
里 共	 @
里 家	 a
里 默	 q
里 佩	 ㄘ
里 签	 帽
里 树	 攫
里 万	 U
里 翁	 
荔枝 树	铼K 攫
栗子 树	撙l 攫
丽 舍	R 
利益 并	Qq }
利用 丰	Qノ 伦
利 昂	Q 
利 并	Q }
利 格	Q 
利 坚	Q 绊
利 佩	Q ㄘ
立场 背	ミ初 I
立场 并	ミ初 }
立即 出	ミY X
立即 发	ミY o
力量 并	Oq }
力求 出	OD X
力 并	O }
力 出	O X
力 格	O 
力 共	O @
力 扑	O 汲
俩 并	 }
联邦国 家	pü瓣 a
联合公报 的	pXそ厨 
联合公报 时	pXそ厨 
联合公报 是	pXそ厨 O
联合公报 说	pXそ厨 弧
联合公报 所	pXそ厨 ┮
联合公报 只	pXそ厨 u
联合公报 中	pXそ厨 い
联合 出	pX X
联合 发	pX o
联欢 共	pw @
联盟 杯	p幅 M
联 共	p @
莲 杯	浆 M
连年 丰	s~ 伦
连续 出	s尿 X
连续 丰	s尿 伦
连夜 出	s] X
连 出	s X
连 发	s o
连 万	s U
帘 布	┅ ガ
脸 涂	y 额
链 斗	渺 矮
炼 出	芬 X
粮食 丰	鲁 伦
粮 并	鲁 }
粮 丰	鲁 伦
梁 坚	辩 绊
梁 树	辩 攫
良策 万	}郸 U
良 并	} }
两者 并	ㄢ }
两者 共	ㄢ @
两 杯	ㄢ M
两 串	ㄢ 
两 家	ㄢ a
两 万	ㄢ U
辆 背	进 I
辆 苏	进 默
量入为出 的	qJ哎X 
量入为出 等	qJ哎X 单
量 丰	q 伦
量 共	q @
亮起 了	G_ F
亮 出	G X
亮 家	G a
聊斋 志	册N в
聊 发	册 o
疗法 的	励k 
疗法 和	励k M
疗法 施	励k I
疗法 是	励k O
疗法 相	励k 
疗法 有	励k Τ
疗法 治	励k v
疗法 中	励k い
疗养院 从	励i| q
疗养院 等	励i| 单
疗养院 去	励i| h
疗养院 研	励i| 
疗 程	励 {
疗 的	励 
疗 都	励 常
疗 毒	励 r
疗 或	励 ┪
疗 机	励 诀
疗 加	励 [
疗 科	励 
疗 时	励 
疗 效	励 
疗 又	励 S
了结 婚	F挡 B
了解 并	F秆 }
了 矮	F G
了 板	F O
了 并	F }
了 布	F ガ
了 采	F 蹦
了 出	F X
了 发	F o
了 丰	F 伦
了 扶	F н
了 格	F 
了 共	F @
了 焊	F k
了 婚	F B
了 家	F a
了 敬	F q
了 佩	F ㄘ
了 扑	F 汲
了 秋	F 
了 殊	F 
了 术	F N
了 树	F 攫
了 苏	F 默
了 万	F U
廖 伦	郭 
料 布	 ガ
列车长 扶	Có н
列出 一	CX @
列举 出	C| X
列宁格勒 的	C圭姘 
列宁格勒 等	C圭姘 单
列宁格勒 队	C圭姘 钉
列宁格勒 和	C圭姘 M
列宁格勒 人	C圭姘 H
列宁格勒 市	C圭姘 カ
列席 党	Cu 囊
列席 了	Cu F
列席 七	Cu C
列席 县	Cu 郡
列 布	C ガ
列 托	C Λ
烈士 家	Ph a
烈士 敬	Ph q
劣种 树	H贺 攫
林地 共	La @
林 并	L }
林 丰	L 伦
林 格	L 
林 共	L @
林 家	L a
林 默	L q
临时政府 并	{涩F┎ }
邻国 签	F瓣 帽
邻居 家	F~ a
玲 并	 }
零售价格 比	s扳基 ゑ
零售价格 等	s扳基 单
零售 额	s扳 B
凌晨 出	獗 X
凌 树	 攫
陵墓 并	钞褂 }
领导人 昂	烩旧H 
领导人 并	烩旧H }
领导人 出	烩旧H X
领导人 格	烩旧H 
领导 发	烩旧 o
领导 共	烩旧 @
领导 签	烩旧 帽
领取 并	烩 }
领头 的	烩Y 
领头 人	烩Y H
领头 雁	烩Y 董
领土 并	烩g }
领袖 佩	烩S ㄘ
领域 并	烩办 }
领域 发	烩办 o
另一 家	t@ a
另 发	t o
令人 敬	OH q
溜 秋	啡 
留念 树	d├ 攫
留 出	d X
刘 家	B a
刘 敬	B q
刘 佩	B ㄘ
刘 树	B 攫
流出 的	yX 
流出 来	yX ㄓ
流出 了	yX F
流露出 的	ySX 
流露出 两	ySX ㄢ
流露出 她	ySX o
流下 泪	yU \
流下 了	yU F
流行病 发	y姣f o
流行 发	y o
柳暗花明 又	ht岍 S
柳树 就	h攫 N
柳条 帽	h兵 U
龙 杯	s M
龙 家	s a
龙 溪	s 匪
楼房 不	加┬ ぃ
楼房 的	加┬ 
楼房 盖	加┬ \
楼房 和	加┬ M
楼房 几	加┬ X
楼房 里	加┬ 
楼房 前	加┬ e
楼房 未	加┬ ゼ
楼房 正	加┬ タ
楼房 中	加┬ い
楼梯 扶	加辫 н
漏洞 的	|} 
漏洞 较	|} 耕
漏洞 太	|} び
漏洞 要	|} n
漏 斗	| 矮
陋 布	 ガ
卢布 的	cガ 
卢布 尔	cガ 焊
卢布 改	cガ э
卢布 和	cガ M
卢布 换	cガ 传
卢布 区	cガ 跋
卢布 为	cガ 
卢 舍	c 
鲁 昂	| 
鲁 布	| ガ
露出 白	SX フ
露出 的	SX 
露出 对	SX 癸
露出 欢	SX w
露出 来	SX ㄓ
露出 了	SX F
露出 水	SX 
露出 一	SX @
露天 采	Sぱ 蹦
路过 采	隔L 蹦
路旁 树	隔 攫
路 杯	隔 M
路 共	隔 @
路 树	隔 攫
陆沉 积	嘲I n
陆续 出	嘲尿 X
陆 丰	嘲 伦
陆 家	嘲 a
吕 格	f 
吕 佩	f ㄘ
吕 树	f 攫
旅客 背	全 I
旅客 出	全 X
旅客 托	全 Λ
旅客 万	全 U
旅行 并	圈 }
旅行 家	圈 a
律师 共	弋v @
率 并	v }
绿化 扶	厚て н
绿化 树	厚て 攫
绿色 丰	厚 伦
绿 裤	厚 壳
绿 树	厚 攫
卵 术	Z N
乱伦 的	睹 
乱 采	睹 蹦
乱 涂	睹 额
掠 并	卑 }
抡 板	绷 O
轮 并	近 }
轮 万	近 U
伦敦 的	鄞 
伦敦 东	鄞 F
伦敦 对	鄞 癸
伦敦 飞	鄞 
伦敦 盖	鄞 \
伦敦 赶	鄞 话
伦敦 哈	鄞 
伦敦 海	鄞 
伦敦 和	鄞 M
伦敦 建	鄞 
伦敦 去	鄞 h
伦敦 时	鄞 
伦敦 斯	鄞 吹
伦敦 温	鄞 放
伦敦 文	鄞 ゅ
伦敦 西	鄞 
伦敦 希	鄞 
伦敦 有	鄞 Τ
伦敦 与	鄞 P
伦敦 溘	鄞 仿
伦 巴	 ぺ
伦 贝	 ī
伦 比	 ゑ
伦 别	 O
伦 伯	 B
伦 布	 ガ
伦 春	 K
伦 茨	 
伦 达	 F
伦 德	 w
伦 的	 
伦 等	 单
伦 迪	 }
伦 蒂	 甫
伦 对	 癸
伦 港	 翠
伦 和	 M
伦 及	 の
伦 继	 ~
伦 贾	 鸽
伦 将	 N
伦 科	 
伦 纳	 
伦 内	 ず
伦 皮	 ブ
伦 坡	 Y
伦 奇	 _
伦 琴	 ^
伦 润	 柬
伦 萨	 履
伦 什	 ぐ
伦 是	 O
伦 市	 カ
伦 说	 弧
伦 斯	 吹
伦 特	 S
伦 托	 Λ
伦 为	 
伦 文	 ゅ
伦 西	 
伦 遗	 框
伦 在	 b
伦 终	 沧
伦 州	 {
伦 珠	 ]
伦 兹	 
沦 溪	_ 匪
萝 卜	炮 R
螺丝帽 便	脸捣U K
螺丝帽 拉	脸捣U ┰
螺旋 焊	脸臂 k
罗布 次	霉ガ Ω
罗布 刻	霉ガ ㄨ
罗布 林	霉ガ L
罗布 萨	霉ガ 履
罗布 是	霉ガ O
罗布 说	霉ガ 弧
罗马尼亚 签	霉皑ェㄈ 帽
罗 家	霉 a
罗 伦	霉 
罗 舍	霉 
罗 苏	霉 默
罗 托	霉 Λ
裸 雕	r J
落脚 树	辅} 攫
落实 扶	辅龟 н
洛阳 市	ザ カ
洛阳 铜	ザ 簧
洛 出	 X
洛 格	 
洛 万	 U
妈妈 吧	洱洱 a
妈妈 抱	洱洱 ╆
妈妈 背	洱洱 I
妈妈 别	洱洱 O
妈妈 车	洱洱 ó
妈妈 从	洱洱 q
妈妈 的	洱洱 
妈妈 奋	洱洱 灸
妈妈 贾	洱洱 鸽
妈妈 可	洱洱 i
妈妈 苦	洱洱 W
妈妈 来	洱洱 ㄓ
妈妈 们	洱洱 
妈妈 捧	洱洱 狈
妈妈 牵	洱洱 o
妈妈 抢	洱洱 m
妈妈 是	洱洱 O
妈妈 太	洱洱 び
妈妈 呀	洱洱 r
妈妈 在	洱洱 b
妈妈 周	洱洱 P
麻布 覆	陈ガ 滦
麻烦 出	陈沸 X
麻疹 发	陈l o
玛 格	嚎 
玛 家	嚎 a
马克 坚	皑J 绊
马克 苏	皑J 默
马裤 呢	皑壳 O
马上 背	皑W I
马术 等	皑N 单
马术 和	皑N M
马术 娴	皑N _
马 背	皑 I
马 格	皑 
马 家	皑 a
马 伦	皑 
马 树	皑 攫
马 托	皑 Λ
马 万	皑 U
买回 家	R^ a
买 秋	R 
麦克 默	沉J q
麦穗 发	沉J o
卖出 的	芥X 
卖出 近	芥X 
卖出 去	芥X h
迈 出	邻 X
满 发	骸 o
满 树	骸 攫
曼 格	耙 
曼 苏	耙 默
漫不经心 的	憨ぃgみ 
漫不经心 想	憨ぃgみ Q
漫步 到	憨B 
漫步 羊	憨B ο
漫步 在	憨B b
漫画家 万	憨ea U
漫画家 张	憨ea i
漫画 集	憨e 栋
漫画 像	憨e 钩
漫漫 的	憨憨 
漫山遍野 都	憨sM偿 常
漫谈 等	憨酵 单
漫谈 之	憨酵 ぇ
漫 沧	憨 飞
漫 长	憨 
漫 的	憨 
漫 堤	憨 出
漫 过	憨 L
漫 话	憨 杠
漫 记	憨 O
漫 满	憨 骸
漫 入	憨 J
漫 山	憨 s
漫 水	憨 
漫 滩	憨 y
漫 天	憨 ぱ
漫 田	憨 バ
漫 湾	憨 W
漫 延	憨 ┑
漫 宜	憨 y
漫 游	憨 村
漫 中	憨 い
漫 瀚	憨 v
盲目 出	讥 X
忙 扶	Γ н
毛 发	を o
毛 家	を a
毛 裤	を 壳
矛盾 并	ベ }
铆 焊	g k
冒 出	_ X
帽徽 和	U啦 M
帽子 的	Ul 
帽子 等	Ul 单
帽子 掉	Ul 奔
帽子 和	Ul M
帽子 后	Ul 
帽子 就	Ul N
帽子 摘	Ul K
帽 的	U 
帽 等	U 单
帽 峰	U p
帽 园	U 堕
贸易壁垒 是	T鼍缆S O
贸易额 不	T雒B ぃ
贸易额 超	T雒B W
贸易额 创	T雒B 承
贸易额 达	T雒B F
贸易额 大	T雒B j
贸易额 的	T雒B 
贸易额 高	T雒B 蔼
贸易额 可	T雒B i
贸易额 却	T雒B o
贸易额 为	T雒B 
贸易额 也	T雒B ]
贸易额 有	T雒B Τ
贸易额 约	T雒B 
贸易额 在	T雒B b
贸易 共	T @
贸 发	T o
么 出	\ X
么 佩	\ ㄘ
么 树	\ 攫
枚 并	T }
梅树 的	宾攫 
梅树 已	宾攫 w
梅 格	宾 
梅 苏	宾 默
梅 托	宾 Λ
煤矿 采	费q 蹦
煤矿 发	费q o
煤炭 采	费 蹦
煤 出	费 X
没有 丰	SΤ 伦
没有 迹	SΤ 格
没 出	S X
每况愈下 的	CpUU 
每年 出	C~ X
每年 发	C~ o
每年 签	C~ 帽
每天 出	Cぱ X
每天 万	Cぱ U
每 采	C 蹦
每 家	C a
美国 杯	瓣 M
美国 并	瓣 }
美国 出	瓣 X
美国 家	瓣 a
美国 舍	瓣 
美军 并	x }
美容 疗	e 励
美容 扑	e 汲
美术爱好者 一	NRn @
美术馆 等	N] 单
美术馆 副	N] 捌
美术馆 举	N] |
美术馆 前	N] e
美术家 的	Na 
美术品 带	N~ a
美术品 货	N~ f
美术品 类	N~ 摸
美术史 论	Nv 阶
美术史 上	Nv W
美术史 专	Nv M
美术 班	N Z
美术 辟	N @
美术 厂	N t
美术 的	N 
美术 等	N 单
美术 柜	N d
美术 和	N M
美术 界	N 
美术 片	N 
美术 师	N v
美术 陶	N 吵
美术 图	N 瓜
美术 为	N 
美术 院	N |
美 杯	 M
美 并	 }
美 发	 o
美 签	 帽
美 苏	 默
妹妹 家	ff a
门 板	 O
门 串	 
门 格	 
门 家	 a
们 并	 }
们 采	 蹦
们 出	 X
们 发	 o
们 丰	 伦
们 扶	 н
们 共	 @
们 家	 a
们 颈	 V
萌 发	缔 o
蒙 格	X 
蒙 苏	X 默
蒙 托	X Λ
盟 并	幅 }
盟 共	幅 @
迷 漫	g 憨
弥漫 的	辣憨 
弥漫 飘	辣憨 钠
弥漫 性	辣憨 ┦
弥漫 在	辣憨 b
弥 万	辣 U
米 板	μ O
米 杯	μ M
米 格	μ 
米 共	μ @
米 家	μ a
秘书长 昂	诞血 
秘书长 布	诞血 ガ
秘书长 格	诞血 
秘书长 佩	诞血 ㄘ
秘书长 苏	诞血 默
秘书长 万	诞血 U
秘书 布	诞 ガ
秘书 格	诞 
秘书 家	诞 a
秘书 托	诞 Λ
密布 的	Kガ 
密切相关 的	Kち勖 
棉裤 穿	粗壳 
棉毛衫 裤	粗をm 壳
棉鞋 帽	粗c U
棉 并	粗 }
免费 发	KO o
面额 共	泵B @
面额 均	泵B А
面额 为	泵B 
面积 丰	笨n 伦
面积 共	笨n @
面面 锦	杯 A
面色 发	宝 o
面上 蹦	堡W 论
面值 大	杯 j
面值 的	杯 
面值 为	杯 
面 出	 X
面 发	 o
苗 发	] o
苗 家	] a
藐 视	缕 跌
妙 迹	М 格
民族学 系	チ壁厩 t
民族学 校	チ壁厩 
民族学 院	チ壁厩 |
民 昂	チ 
民 采	チ 蹦
民 共	チ @
民 万	チ U
明尼苏达州 的	ェ默F{ 
明显 比	陪 ゑ
明显 变	陪 跑
明显 并	陪 }
明显 不	陪 ぃ
明显 成	陪 Θ
明显 大	陪 j
明显 的	陪 
明显 等	陪 单
明显 低	陪 C
明显 地	陪 a
明显 而	陪 τ
明显 放	陪 
明显 高	陪 蔼
明显 好	陪 n
明显 和	陪 M
明显 缓	陪 w
明显 回	陪 ^
明显 减	陪 搭
明显 降	陪 
明显 看	陪 
明显 疗	陪 励
明显 偏	陪 熬
明显 趋	陪 镣
明显 少	陪 ぶ
明显 效	陪 
明显 优	陪 u
明争暗斗 多	Хt矮 h
明 杯	 M
明 出	 X
明 斗	 矮
明 发	 o
明 伦	 
明 秋	 
明 术	 N
明 溪	 匪
鸣 苏	伙 默
名额 等	WB 单
名额 和	WB M
名额 由	WB パ
名画 家	We a
名家 辈	Wa 晋
名家 长	Wa 
名家 的	Wa 
名家 给	Wa 倒
名家 沈	Wa H
名家 示	Wa ボ
名家 曾	Wa 纯
名家 之	Wa ぇ
名将 布	WN ガ
名将 伦	WN 
名将 默	WN q
名义 发	Wq o
名誉主席 楚	WADu 贰
名誉主席 黄	WADu 独
名誉主席 金	WADu 
名誉主席 康	WADu d
名誉主席 屈	WADu }
名誉主席 宋	WADu Ш
名誉主席 万	WADu U
名誉主席 许	WADu \
名誉主席 张	WADu i
名 采	W 蹦
名 出	W X
命运 舍	RB 
摸索 出	N X
摸 出	N X
模 家	家 a
磨 出	i X
摩托车 被	集Λó Q
摩托车 厂	集Λó t
摩托车 的	集Λó 
摩托车 等	集Λó 单
摩托车 队	集Λó 钉
摩托车 近	集Λó 
摩托车 在	集Λó b
摩托车 制	集Λó 
摩托车 总	集Λó `
摩 苏	集 默
摩 托	集 Λ
魔术师 式	]Nv Α
魔术 和	]N M
魔术 似	]N 
抹布 擦	┵ガ 揽
抹布 揩	┵ガ {
末 发	ソ o
莫斯科 签	馋吹 帽
莫 格	馋 
墨迹 被	茎格 Q
墨迹 未	茎格 ゼ
默默无闻 的	qqLD 
默默无闻 地	qqLD a
默默 的	qq 
默默 地	qq a
默默 扎	qq 蚕
默契 的	q 
默然 近	qM 
默然 是	qM O
默然 说	qM 弧
默 哀	q s
默 川	q t
默 茨	q 
默 德	q w
默 的	q 
默 等	q 单
默 迪	q }
默 顿	q y
默 多	q h
默 尔	q 焊
默 涵	q [
默 和	q M
默 还	q 临
默 将	q N
默 就	q N
默 拉	q ┰
默 勒	q 扒
默 里	q 
默 森	q 此
默 时	q 
默 说	q 弧
默 斯	q 吹
默 一	q @
默 伊	q レ
默 在	q b
默 庵	q g
某 家	Y a
亩 丰	a 伦
姆 杯	i M
姆 格	i 
姆 佩	i ㄘ
母校 的	ダ 
母校 开	ダ }
母校 随	ダ H
母校 作	ダ @
幕 布	辊 ガ
木板 拼	れO 
木板 上	れO W
木材 采	れ 蹦
木地板 除	れaO 埃
木雕 画	れJ e
木雕 像	れJ 钩
木麻黄 树	れ陈独 攫
木 格	れ 
木 家	れ a
木 树	れ 攫
木 托	れ Λ
目标 并	ヘ夹 }
目前 并	ヘe }
牧 杯	 M
穆罕默德 的	puqw 
穆罕默德 和	puqw M
穆罕默德 任	puqw ヴ
拿出 百	偿X κ
拿出 大	偿X j
拿出 的	偿X 
拿出 更	偿X 
拿出 几	偿X X
拿出 仅	偿X 度
拿出 近	偿X 
拿出 勘	偿X 吧
拿出 理	偿X z
拿出 了	偿X F
拿出 名	偿X W
拿出 七	偿X C
拿出 钱	偿X 窥
拿出 三	偿X T
拿出 四	偿X |
拿出 些	偿X ㄇ
拿出 研	偿X 
拿出 一	偿X @
拿出 在	偿X b
拿出 这	偿X o
拿出 真	偿X u
拿出 质	偿X 借
拿出 中	偿X い
拿出 总	偿X `
拿 家	 a
哪 出	 X
哪 家	 a
那些 家	êㄇ a
那样 发	ê妓 o
那 背	ê I
那 布	ê ガ
那 家	ê a
纳 并	 }
纳 布	 ガ
纳 格	 
纳 坚	 绊
纳 签	 帽
奶 家	イ a
南方 杯	nよ M
南斯拉夫 签	n吹┰ひ 帽
南 布	n ガ
南 采	n 蹦
南 丰	n 伦
南 扶	n н
南 共	n @
南 家	n a
南 签	n 帽
南 溪	n 匪
男女 共	kk @
男子 并	kl }
男子 万	kl U
难看 出	螟 X
难 舍	螟 
恼人 的	oH 
恼 火	o 
恼 了	o F
闹 出	x X
内部 共	ず场 @
内地 丰	ずa 伦
内地 万	ずa U
内含 丰	ずt 伦
内容 并	ずe }
内容 丰	ずe 伦
内 并	ず }
内 斗	ず 矮
内 共	ず @
内 涂	ず 额
能干 出	喾F X
能工巧匠 开	啶uォK }
能工巧匠 在	啶uォK b
能够 把	喟 р
能够 办	喟 快
能够 被	喟 Q
能够 不	喟 ぃ
能够 测	喟 代
能够 产	喟 玻
能够 成	喟 Θ
能够 承	喟 ┯
能够 出	喟 X
能够 创	喟 承
能够 从	喟 q
能够 大	喟 j
能够 带	喟 a
能够 得	喟 o
能够 对	喟 癸
能够 多	喟 h
能够 躲	喟 跟
能够 搞	喟 d
能够 合	喟 X
能够 很	喟 
能够 唤	喟 酬
能够 计	喟 p
能够 讲	喟 量
能够 较	喟 耕
能够 尽	喟 荷
能够 经	喟 g
能够 救	喟 毕
能够 就	喟 N
能够 迈	喟 邻
能够 拿	喟 
能够 起	喟 _
能够 使	喟 ㄏ
能够 算	喟 衡
能够 同	喟 P
能够 为	喟 
能够 信	喟 H
能够 永	喟 ッ
能够 用	喟 ノ
能够 与	喟 P
能够 再	喟 A
能够 在	喟 b
能够 制	喟 
能够 准	喟 
能够 做	喟 暗
能力 并	啶O }
能力 出	啶O X
能 背	 I
能 并	 }
能 出	 X
能 雕	 J
能 丰	 伦
能 共	 @
能 签	 帽
泥 迹	d 格
尼泊尔 签	ェy焊 帽
尼 采	ェ 蹦
尼 出	ェ X
尼 格	ェ 
拟定 出	览w X
拟定 苏	览w 默
拟 出	览 X
你 铲	A 藐
你 出	A X
你 斗	A 矮
你 家	A a
匿 迹	拔 格
年初 签	~ 帽
年代 扶	~N н
年底 签	~┏ 帽
年华 舍	~地 
年金 秋	~ 
年年 出	~~ X
年年 发	~~ o
年轻 发	~淮 o
年 采	~ 蹦
年 出	~ X
年 斗	~ 矮
年 发	~ o
年 丰	~ 伦
年 共	~ @
年 秋	~ 
念书 的	├ 
娘 发	Q o
娘 家	Q a
娘 托	Q Λ
鸟巢 猛	尘_ r
聂 家	驴 a
凝聚 坚	井E 绊
宁夏 丰	圭L 伦
宁 家	圭 a
牛棚 格	醋 
牛 背	 I
牛 家	 a
纽伦堡 同	铆鄢 P
浓妆 的	@З 
浓妆 艳	@З A
农场 舍	A初 
农户 串	Aめ 
农户 家	Aめ a
农家 备	Aa 称
农家 播	Aa 冀
农家 藏	Aa 旅
农家 的	Aa 
农家 肥	Aa 
农家 后	Aa 
农家 活	Aa 
农家 或	Aa ┪
农家 炕	Aa 
农家 牧	Aa 
农家 却	Aa o
农家 事	Aa ㄆ
农家 小	Aa p
农家 写	Aa g
农家 已	Aa w
农家 用	Aa ノ
农家 院	Aa |
农民 昂	Aチ 
农民 串	Aチ 
农民 发	Aチ o
农民 扶	Aチ н
农民 共	Aチ @
农民 家	Aチ a
农民 签	Aチ 帽
农舍 里	A 
农药 共	A媚 @
农业部 丰	A~场 伦
农业 丰	A~ 伦
农业 共	A~ @
农作物 丰	A@ 伦
农 杯	A M
农 出	A X
农 签	A 帽
弄 出	 X
弄 树	 攫
努力 并	VO }
努力 发	VO o
怒气 和	惝 M
女儿 扶	kㄠ н
女画家 玛	kea 嚎
女画家 吴	kea d
女画家 携	kea 拟
女画家 张	kea i
女王 的	k 
女王 伊	k レ
女王 在	k b
女王 驻	k n
女政治家 访	kFva X
女作家 巴	k@a ぺ
女作家 航	k@a 
女作家 刘	k@a B
女作家 石	k@a ホ
女作家 王	k@a 
女作家 杨	k@a 法
女作家 曾	k@a 纯
女 共	k @
女 焊	k k
暖 万	x U
诺 布	空 ガ
欧洲 杯	稼w M
欧 共	稼 @
欧 佩	稼 ㄘ
爬 树	 攫
怕 邢	┤ ǚ
拍板 不	╃O ぃ
拍板 的	╃O 
拍照 的	╃酚 
拍 发	╃ o
排出 的	逼X 
排出 访	逼X X
排出 年	逼X ~
排出 品	逼X ~
排出 前	逼X e
排出 这	逼X o
排出 最	逼X 程
排挤 出	逼澜 X
排 丰	逼 伦
牌 杯	P M
派出所 的	％X┮ 
派出所 等	％X┮ 单
派出所 地	％X┮ a
派出所 干	％X┮ F
派出所 和	％X┮ M
派出所 还	％X┮ 临
派出所 警	％X┮ 牡
派出所 民	％X┮ チ
派出所 向	％X┮ V
派出所 在	％X┮ b
派出所 正	％X┮ タ
派 并	 }
派 出	 X
派 丰	 伦
派 共	 @
盘 托	L Λ
乓 赛	ャ 辽
旁 树	 攫
抛 出	┻ X
刨花 板	S O
炮火 熏	钉 饫
炮 术	 N
跑出 了	]X F
跑出 去	]X h
跑出 绕	]X 露
跑出 治	]X v
胚胎 术	FL N
培养 出	蚌i X
培育 出	蚌| X
培植 出	蚌从 X
裴 家	p a
赔偿费 的	竭vO 
赔偿费 由	竭vO パ
配额 的	tB 
配额 和	tB M
配给 额	t倒 B
配合 家	tX a
配 发	t o
佩带 者	ㄘa 
佩服 的	ㄘA 
佩服 地	ㄘA a
佩服 和	ㄘA M
佩服 他	ㄘA L
佩剑 的	ㄘC 
佩剑 角	ㄘC à
佩 戴	ㄘ 拦
佩 到	ㄘ 
佩 德	ㄘ w
佩 的	ㄘ 
佩 等	ㄘ 单
佩 定	ㄘ w
佩 尔	ㄘ 焊
佩 副	ㄘ 捌
佩 和	ㄘ M
佩 季	ㄘ u
佩 君	ㄘ g
佩 卡	ㄘ d
佩 克	ㄘ J
佩 莱	ㄘ 弟
佩 蓝	ㄘ 屡
佩 雷	ㄘ p
佩 里	ㄘ 
佩 鲁	ㄘ |
佩 吕	ㄘ f
佩 纳	ㄘ 
佩 奇	ㄘ _
佩 去	ㄘ h
佩 三	ㄘ T
佩 施	ㄘ I
佩 说	ㄘ 弧
佩 斯	ㄘ 吹
佩 特	ㄘ S
佩 同	ㄘ P
佩 维	ㄘ 蝴
佩 文	ㄘ ゅ
佩 西	ㄘ 
佩 希	ㄘ 
佩 弦	ㄘ ┒
佩 向	ㄘ V
佩 一	ㄘ @
佩 伊	ㄘ レ
佩 英	ㄘ ^
佩 云	ㄘ 冻
佩 在	ㄘ b
佩 扎	ㄘ 蚕
佩 占	ㄘ 
佩 证	ㄘ 谍
佩 瑛	ㄘ 冯
喷出 的	QX 
喷出 了	QX F
喷出 水	QX 
喷射 出	Qg X
喷 发	Q o
喷 涂	Q 额
彭 家	^ a
彭 佩	^ ㄘ
捧 杯	狈 M
捧 出	狈 X
碰出 声	IX n
碰 杯	I M
批驳 了	у婚 F
批驳 其	у婚 ㄤ
批发价 格	уo基 
批发商 店	уo坝 ┍
批发商 坐	уo坝 Г
批发市场 办	уoカ初 快
批发市场 的	уoカ初 
批发市场 对	уoカ初 癸
批发市场 和	уoカ初 M
批发市场 将	уoカ初 N
批发市场 立	уoカ初 ミ
批发 部	уo 场
批发 出	уo X
批发 等	уo 单
批发 和	уo M
批发 面	уo 
批发 与	уo P
批发 站	уo 
批评 并	у蝶 }
批准 并	у }
批准 布	у ガ
批 布	у ガ
批 斗	у 矮
批 共	у @
批 焊	у k
劈 出	A X
皮层 下	ブh U
皮 帽	ブ U
片 并	 }
片 采	 蹦
片 丰	 伦
片 共	 @
片 树	 攫
飘 出	钠 X
票价 格	布基 
撇下 家	JU a
频频 出	WW X
贫 出	h X
品格 在	~ b
品 出	~ X
品 丰	~ 伦
乒乓球 不	モャy ぃ
乒乓球 打	モャy ゴ
乒乓球 单	モャy 虫
乒乓球 的	モャy 
乒乓球 队	モャy 钉
乒乓球 馆	モャy ]
乒乓球 和	モャy M
乒乓球 男	モャy k
乒乓球 女	モャy k
乒乓球 拍	モャy ╃
乒乓球 赛	モャy 辽
乒乓球 是	モャy O
乒乓球 室	モャy 
乒乓球 台	モャy x
乒乓球 为	モャy 
乒乓球 小	モャy p
乒乓球 巡	モャy ǖ
乒乓球 也	モャy ]
乒乓 女	モャ k
乒乓 赛	モャ 辽
乒乓 室	モャ 
乒乓 之	モャ ぇ
乒乓 主	モャ D
乒乓 桌	モャ 
苹果 树	墨G 攫
平板玻璃 厂	キO良 t
平常 的	キ` 
平常 对	キ` 癸
平常 他	キ` L
平常 心	キ` み
平常 在	キ` b
平衡 并	キ颗 }
平面 布	キ ガ
平壤 签	キ[ 帽
平壤 万	キ[ U
平整 出	キ俱 X
平 布	キ ガ
凭著 丰	咎帝 伦
评定 出	蝶w X
评价 并	蝶基 }
评论家 陈	蝶阶a 朝
评论家 称	蝶阶a 嘿
评论家 的	蝶阶a 
评论家 及	蝶阶a の
评 并	蝶 }
评 出	蝶 X
颇 丰	会 伦
婆婆家 的	CCa 
婆婆 出	CC X
破坏 并	}a }
破 格	} 
扑鼻 的	汲惑 
扑克牌 和	汲JP M
扑克牌 那	汲JP ê
扑克 的	汲J 
扑面 而	汲 τ
扑灭 的	汲防 
扑灭 火	汲防 
扑灭 了	汲防 F
扑灭 扑	汲防 汲
扑灭 山	汲防 s
扑灭 它	汲防 ウ
扑灭 一	汲防 @
扑上去 把	汲Wh р
扑上去 死	汲Wh 
扑朔迷离 的	汲野g瞒 
扑向 车	汲V ó
扑向 佟	汲V c
扑 把	汲 р
扑 出	汲 X
扑 到	汲 
扑 掉	汲 奔
扑 跪	汲 各
扑 火	汲 
扑 进	汲 i
扑 救	汲 毕
扑 来	汲 ㄓ
扑 了	汲 F
扑 去	汲 h
扑 上	汲 W
扑 腾	汲 乃
扑 下	汲 U
扑 在	汲 b
扑 簌	汲 P
铺 板	Q O
仆 关	共 闽
普遍 发	炊M o
普遍 丰	炊M 伦
普通人 家	炊qH a
普 并	炊 }
普 布	炊 ガ
瀑布 树	rガ 攫
期待 并	戳 }
期间 共	戳丁 @
期间 万	戳丁 U
期刊 出	戳Z X
期满 出	戳骸 X
期 共	戳 @
戚 德	杯 w
戚 继	杯 ~
戚 丽	杯 R
戚 墅	杯 怪
戚 元	杯 じ
妻子 共	dl @
七 家	C a
凄惨 的	YG 
凄 然	Y M
漆树 林	海攫 L
其他 并	ㄤL }
其他 扶	ㄤL н
其 格	ㄤ 
其 疗	ㄤ 励
其 婉	ㄤ 胞
棋手 布	囱も ガ
棋 家	囱 a
奇特 疗	_S 励
奇 并	_ }
奇 出	_ X
奇 斗	_ 矮
奇 迹	_ 格
齐 布	霍 ガ
齐 家	霍 a
祁 家	 a
骑 术	M N
起草 出	_ X
起来 并	_ㄓ }
起来 共	_ㄓ @
起义 并	_q }
起 发	_ o
起 丰	_ 伦
起 共	_ @
起 家	_ a
起 塌	_ 厄
起 万	_ U
企图夺取 并	瓜管 }
企图 发	瓜 o
企业家 到	~a 
企业家 的	~a 
企业家 都	~a 常
企业家 访	~a X
企业家 和	~a M
企业家 奖	~a 贱
企业家 金	~a 
企业家 栗	~a 
企业家 了	~a F
企业家 吗	~a 盾
企业家 们	~a 
企业家 难	~a 螟
企业家 说	~a 弧
企业家 孙	~a ]
企业家 向	~a V
企业家 要	~a n
企业家 在	~a b
企业家 张	~a i
企业家 之	~a ぇ
企业 并	~ }
企业 布	~ ガ
企业 出	~ X
企业 发	~ o
企业 共	~ @
企业 签	~ 帽
启程 出	币{ X
启发 病	币o f
启发 很	币o 
启发 了	币o F
启发 性	币o ┦
启发 职	币o 戮
器具 共	竟ㄣ @
器械 出	竟瘪 X
器械 共	竟瘪 @
气味 熏	皎 饫
气象学 家	鸲H厩 a
气象 万	鸲H U
气宇轩昂 的	穰ta 
气 背	 I
气 并	 }
气 焊	 k
迄今 并	ùさ }
迄今 苏	ùさ 默
弃 家	斌 a
恰 卜	 R
千变万化 的	d跑Uて 
千差万别 的	dtUO 
千呼万唤 不	dIU酬 ぃ
千军万马 齐	dxU皑 霍
千千万万 的	ddUU 
千千万万 个	ddUU 
千千万万 颗	ddUU 聋
千千万万 雷	ddUU p
千千万万 人	ddUU H
千千万万 象	ddUU H
千千万万 严	ddUU Y
千千万万 在	ddUU b
千千万万 指	ddUU 
千秋 大	d j
千秋 发	d o
千秋 伟	d 岸
千秋 在	d b
千头万绪 的	dYU狐 
千万 别	dU O
千万 不	dU ぃ
千万 册	dU U
千万 吨	dU 痉
千万 个	dU 
千万 户	dU め
千万 回	dU ^
千万 计	dU p
千万 间	dU 丁
千万 里	dU 
千万 亩	dU a
千万 人	dU H
千万 头	dU Y
千万 要	dU n
千万 元	dU じ
千万 在	dU b
千万 字	dU r
千元 树	dじ 攫
千 发	d o
千 家	d a
千 树	d 攫
迁移 出	E簿 X
迁 出	E X
签到簿 比	帽烀 ゑ
签名 边	帽W 娩
签名 簿	帽W 茂
签名 彩	帽W m
签名 的	帽W 
签名 看	帽W 
签名 也	帽W ]
签署 到	帽p 
签署 德	帽p w
签署 的	帽p 
签署 第	帽p 材
签署 对	帽p 癸
签署 复	帽p _
签署 该	帽p 赣
签署 关	帽p 闽
签署 过	帽p L
签署 和	帽p M
签署 后	帽p 
签署 还	帽p 临
签署 减	帽p 搭
签署 经	帽p g
签署 两	帽p ㄢ
签署 了	帽p F
签署 毛	帽p を
签署 南	帽p n
签署 数	帽p 计
签署 双	帽p 蛮
签署 斯	帽p 吹
签署 新	帽p s
签署 一	帽p @
签署 这	帽p o
签约仪式 在	帽祸Α b
签约 的	帽 
签约 国	帽 瓣
签约 近	帽 
签章 的	帽彻 
签章 后	帽彻 
签证 的	帽谍 
签证 等	帽谍 单
签证 事	帽谍 ㄆ
签字 毕	帽r 拨
签字 的	帽r 
签字 国	帽r 瓣
签字 一	帽r @
签字 有	帽r Τ
签 的	帽 
签 定	帽 w
签 订	帽 q
签 发	帽 o
签 封	帽 
签 个	帽 
签 和	帽 M
签 两	帽 ㄢ
签 了	帽 F
签 批	帽 у
签 上	帽 W
签 式	帽 Α
签 收	帽 Μ
签 苏	帽 默
签 外	帽 ~
签 一	帽 @
签 由	帽 パ
签 有	帽 Τ
签 这	帽 o
钱 额	窥 B
钱 家	窥 a
钱 树	窥 攫
钱 万	窥 U
前后 共	e @
前景 并	e春 }
前来 共	eㄓ @
前来 敬	eㄓ q
前来 万	eㄓ U
前列腺炎 及	eC涪 の
前列腺 边	eC涪 娩
前列腺 的	eC涪 
前提 出	e矗 X
前途 并	e~ }
前往 格	e┕ 
前夕 签	ei 帽
前 并	e }
前 额	e B
前 发	e o
前 丰	e 伦
前 敬	e q
前 默	e q
前 佩	e ㄘ
前 扑	e 汲
前 仆	e 共
潜水艇 的	肩舾 
潜水艇 等	肩舾 单
潜水艇 在	肩舾 b
潜心 雕	肩み J
潜移默化 地	肩簿qて a
潜 出	肩 X
谴责 并	宁d }
强化 共	jて @
抢救 并	m毕 }
抢救 出	m毕 X
抢先 出	m X
抢 出	m X
抢 发	m o
锹 铲	陵 藐
敲 出	V X
乔 布	踌 ガ
乔 格	踌 
侨胞 共	勾M @
侨民 共	勾チ @
切 出	ち X
钦佩 的	窜ㄘ 
亲笔签名 的	克掸帽W 
亲笔信 中	克掸H い
亲笔 给	克掸 倒
亲笔 题	克掸 D
亲笔 为	克掸 
亲戚 打	克杯 ゴ
亲戚 到	克杯 
亲戚 的	克杯 
亲戚 家	克杯 a
亲戚 间	克杯 丁
亲戚 就	克杯 N
亲戚 们	克杯 
亲戚 呢	克杯 O
亲戚 穷	克杯 a
亲戚 乡	克杯 m
亲戚 也	克杯 ]
亲自 出	克 X
亲 串	克 
秦 万	 U
禽 出	V X
沁 出	G X
青梅 树	C宾 攫
青年人 婚	C~H B
青年 婚	C~ B
青年 汲	C~ V
青年 树	C~ 攫
青少年 共	Cぶ~ @
青少年 敬	Cぶ~ q
倾听 苏	渡钮 默
清理 出	Mz X
清廉 万	MG U
清 板	M O
清 并	M }
清 出	M X
清 丰	M 伦
清 苏	M 默
情况 比	薄p ゑ
情况 并	薄p }
情况 不	薄p ぃ
情况 存	薄p s
情况 答	薄p 氮
情况 大	薄p j
情况 的	薄p 
情况 等	薄p 单
情况 都	薄p 常
情况 对	薄p 癸
情况 而	薄p τ
情况 反	薄p は
情况 复	薄p _
情况 各	薄p U
情况 给	薄p 倒
情况 更	薄p 
情况 公	薄p そ
情况 好	薄p n
情况 和	薄p M
情况 很	薄p 
情况 狠	薄p 
情况 后	薄p 
情况 还	薄p 临
情况 会	薄p |
情况 汇	薄p 蹲
情况 及	薄p の
情况 简	薄p 虏
情况 将	薄p N
情况 较	薄p 耕
情况 就	薄p N
情况 均	薄p А
情况 看	薄p 
情况 可	薄p i
情况 来	薄p ㄓ
情况 良	薄p }
情况 了	薄p F
情况 落	薄p 辅
情况 难	薄p 螟
情况 去	薄p h
情况 却	薄p o
情况 让	薄p 琵
情况 仍	薄p ご
情况 若	薄p Y
情况 少	薄p ぶ
情况 时	薄p 
情况 是	薄p O
情况 虽	薄p 瘤
情况 同	薄p P
情况 外	薄p ~
情况 我	薄p и
情况 下	薄p U
情况 相	薄p 
情况 向	薄p V
情况 新	薄p s
情况 选	薄p 匡
情况 也	薄p ]
情况 已	薄p w
情况 以	薄p H
情况 尤	薄p ぷ
情况 有	薄p Τ
情况 又	薄p S
情况 于	薄p _
情况 予	薄p ぉ
情况 与	薄p P
情况 再	薄p A
情况 在	薄p b
情况 怎	薄p 
情况 转	薄p 锣
情况 最	薄p 程
情况 做	薄p 暗
情况 作	薄p @
情 并	薄 }
情 出	薄 X
情 树	薄 攫
请 昂	叫 
请 签	叫 帽
请 万	叫 U
庆 发	y o
庆 丰	y 伦
庆 家	y a
庆 舍	y 
琼 布	茫 ガ
秋风 的	瞽 
秋风 里	瞽 
秋风 乍	瞽 E
秋高气爽 的	畎鸩n 
秋季 把	瞟u р
秋季 到	瞟u 
秋季 各	瞟u U
秋季 广	瞟u s
秋季 号	瞟u 腹
秋季 民	瞟u チ
秋季 前	瞟u e
秋季 作	瞟u @
秋收 打	瞀 ゴ
秋收 秋	瞀 
秋收 万	瞀 U
秋天 不	瞍 ぃ
秋天 储	瞍 x
秋天 给	瞍 倒
秋天 将	瞍 N
秋天 霜	瞍 流
秋天 他	瞍 L
秋天 一	瞍 @
秋天 又	瞍 S
秋天 在	瞍 b
秋雨 而	瞰B τ
秋雨 中	瞰B い
秋 保	 O
秋 备	 称
秋 被	 Q
秋 并	 }
秋 播	 冀
秋 补	 干
秋 菜	 垫
秋 从	 q
秋 的	 
秋 等	 单
秋 冬	 V
秋 对	 癸
秋 翻	 陆
秋 防	 
秋 副	 捌
秋 冈	 
秋 割	 澄
秋 给	 倒
秋 更	 
秋 和	 M
秋 后	 
秋 还	 临
秋 及	 の
秋 将	 N
秋 教	 毙
秋 克	 J
秋 来	 ㄓ
秋 涝	 妩
秋 里	 
秋 连	 s
秋 粮	 鲁
秋 玲	 
秋 率	 v
秋 明	 
秋 末	 ソ
秋 萍	 涤
秋 起	 _
秋 千	 d
秋 日	 ら
秋 荣	 a
秋 莎	 诧
秋 设	 ]
秋 时	 
秋 是	 O
秋 说	 弧
秋 同	 P
秋 香	 
秋 向	 V
秋 一	 @
秋 衣	 
秋 与	 P
秋 越	 V
秋 云	 冻
秋 整	 俱
秋 正	 タ
秋 之	 ぇ
秋 种	 贺
球 板	y O
趋势 并	镣墩 }
趋向 规	镣V W
趋向 激	镣V E
趋向 及	镣V の
趋向 坚	镣V 绊
趋向 可	镣V i
区长 签	跋 帽
区段 共	跋q @
区分 布	跋だ ガ
区域 扶	跋办 н
区 并	跋 }
区 扶	跋 н
区 共	跋 @
区 签	跋 帽
区 万	跋 U
曲面 陡	Ρ ~
曲 格	Ρ 
驱逐出境 等	XvX挂 单
取出 了	X F
取得 丰	o 伦
去年 采	h~ 蹦
去年 出	h~ X
去年 发	h~ o
去年 丰	h~ 伦
去年 共	h~ @
去年 签	h~ 帽
去年 秋	h~ 
去年 苏	h~ 默
去 采	h 蹦
去 扶	h н
去 秋	h 
圈 出	伴 X
权力斗争 的	vO矮 
权力斗争 自	vO矮 
权 发	v o
泉 家	u a
全部 出	场 X
全国 并	瓣 }
全国 出	瓣 X
全国 扶	瓣 н
全国 共	瓣 @
全国 家	瓣 a
全家 吃	a Y
全家 的	a 
全家 都	a 常
全家 对	a 癸
全家 给	a 倒
全家 合	a X
全家 很	a 
全家 及	a の
全家 九	a E
全家 老	a ρ
全家 乐	a 贾
全家 没	a S
全家 迁	a E
全家 人	a H
全家 说	a 弧
全家 喜	a 尺
全家 向	a V
全家 曾	a 纯
全家 照	a 酚
全家 住	a 
全军 共	x @
全面 丰	 伦
全年 共	~ @
全年 签	~ 帽
全世界 共	@ @
全市 发	カ o
全市 共	カ @
全月 共	る @
全 斗	 矮
全 额	 B
全 树	 攫
全 苏	 默
缺额 达	拭B F
缺额 也	拭B ]
缺 树	 攫
却又 扑	oS 汲
却又 舍	oS 
却 背	o I
却 并	o }
却 出	o X
却 婉	o 胞
确保 丰	TO 伦
群众 并	s渤 }
群众 共	s渤 @
群众 家	s渤 a
染 发	V o
让出 百	琵X κ
让出 一	琵X @
让 家	琵 a
绕 树	露 攫
惹恼 了	So F
热烈欢迎 并	荐Pw }
热 发	荐 o
热 疗	荐 励
仁 布	く ガ
人格 的	H 
人格 国	H 瓣
人格 和	H M
人格 是	H O
人迹 罕	H格 u
人口 共	Hf @
人类学家 曾	H摸厩a 纯
人力 背	HO I
人力 并	HO }
人民 背	Hチ I
人民 斗	Hチ 矮
人民 发	Hチ o
人民 共	Hチ @
人民 敬	Hチ q
人群 雕	Hs J
人生 发	Hネ o
人士 共	Hh @
人士 莅	Hh Y
人事 迹	Hㄆ 格
人头税 代	HY| N
人头税 法	HY| k
人头税 是	HY| O
人心 弦	Hみ ┒
人员 并	H }
人员 发	H o
人员 共	H @
人员 签	H 帽
人员 苏	H 默
人造 板	Hy O
人 背	H I
人 并	H }
人 出	H X
人 丰	H 伦
人 共	H @
人 家	H a
人 佩	H ㄘ
人 术	H N
人 托	H Λ
任何 迹	ヴ 格
任务 并	ヴ叭 }
任职期 间	ヴ戮戳 丁
任 家	ヴ a
认出 了	{X F
认出 是	{X O
认识 并	{醚 }
认为 苏	{ 默
扔出 的	サX 
扔出 去	サX h
扔下 了	サU F
扔下 手	サU も
扔下 一	サU @
仍然 树	ごM 攫
仍是 苏	ごO 默
仍 痴	ご 扶
日本共同社 报	らセ@P 厨
日本 丰	らセ 伦
日出 而	らX τ
日出 夫	らX ひ
日出 港	らX 翠
日出 口	らX f
日出 任	らX ヴ
日出 一	らX @
日出 院	らX |
日出 战	らX 驹
日出 站	らX 
日出 之	らX ぇ
日后 出	ら X
日趋 丰	ら镣 伦
日 并	ら }
日 布	ら ガ
日 发	ら o
日 疗	ら 励
日 苏	ら 默
荣 并	a }
荣 丰	a 伦
融合 术	磕X N
融洽 的	磕 
融洽 关	磕 闽
融洽 了	磕 F
融资 额	磕戈 B
容量 共	eq @
容易 出	e X
容 并	e }
绒 布	党 ガ
柔术 转	XN 锣
肉类 等	ψ摸 单
肉类 调	ψ摸 秸
肉类 奶	ψ摸 イ
肉类 已	ψ摸 w
肉类 占	ψ摸 
肉类 总	ψ摸 `
肉食 等	ψ 单
肉 斗	ψ 矮
如此 丰	p 伦
如果 格	pG 
如数家珍 地	p计a a
如数家珍 似	p计a 
如意 杯	pN M
如 痴	p 扶
如 家	p a
如 苏	p 默
入不敷出 的	Jぃ寂X 
入境签证 的	J挂帽谍 
入 出	J X
入 秋	J 
入 托	J Λ
瑞士 苏	风h 默
若 昂	Y 
若 出	Y X
洒 出	s X
萨 布	履 ガ
萨 采	履 蹦
萨 格	履 
萨 苏	履 默
塞尔维亚 共	峨焊蝴ㄈ @
塞浦路斯 的	峨隔吹 
塞浦路斯 队	峨隔吹 钉
塞浦路斯 各	峨隔吹 U
塞浦路斯 和	峨隔吹 M
塞浦路斯 后	峨隔吹 
塞浦路斯 将	峨隔吹 N
塞浦路斯 两	峨隔吹 ㄢ
塞浦路斯 人	峨隔吹 H
塞浦路斯 土	峨隔吹 g
塞浦路斯 希	峨隔吹 
塞浦路斯 一	峨隔吹 @
塞 格	峨 
塞 佩	峨 ㄘ
塞 万	峨 U
赛 出	辽 X
赛 格	辽 
赛 共	辽 @
赛 苏	辽 默
三 家	T a
散布 了	床ガ F
散布 说	床ガ 弧
散布 羊	床ガ ο
散布 在	床ガ b
散布 著	床ガ 帝
散发 长	床o 
散发 出	床o X
散发 的	床o 
散发 感	床o P
散发 给	床o 倒
散发 了	床o F
散发 著	床o 帝
桑 布	 ガ
桑 格	 
桑 家	 a
桑 坚	 绊
桑 托	 Λ
扫描器 拣	苯y竟 z
嫂 树	A 攫
森林 并	此L }
森 并	此 }
僧尼 共	宫ェ @
杀 家	炳 a
刹 婚	b B
沙发 等	Fo 单
沙发 垫	Fo 乖
沙发 都	Fo 常
沙发 画	Fo e
沙发 巾	Fo y
沙发 上	Fo W
沙拉 布	F┰ ガ
沙 逼	F G
沙 出	F X
沙 佩	F ㄘ
沙 万	F U
纱 布	 ガ
筛选 出	z匡 X
杉木 秋	れ 
杉树 林	攫 L
杉树 苗	攫 ]
杉树 蓄	攫 W
杉树 已	攫 w
山路 敬	s隔 q
山区 扶	s跋 н
山区 敬	s跋 q
山水画家 们	s舻ea 
山西 发	s o
山羊 板	sο O
山楂 树	s萦 攫
山 杯	s M
山 背	s I
山 堤	s 出
山 万	s U
山 兮	s ぜ
闪 出	{ X
擅自 出	菊 X
善 溪	到 匪
墒 秋	a 
商定 苏	坝w 默
商会 共	坝| @
商业 共	坝~ @
商议 签	坝某 帽
商 并	坝 }
商 签	坝 帽
上海 万	W U
上届 格	W 
上面 共	W @
上山 采	Ws 蹦
上述 发	Wz o
上台 发	Wx o
上午 发	Wと o
上 板	W O
上 背	W I
上 并	W }
上 采	W 蹦
上 发	W o
上 丰	W 伦
上 共	W @
上 焊	W k
上 家	W a
上 扑	W 汲
上 签	W 帽
上 舍	W 
上 树	W 攫
上 苏	W 默
上 万	W U
烧香 敬	N q
少 并	ぶ }
少 发	ぶ o
少 共	ぶ @
少 树	ぶ 攫
少 溪	ぶ 匪
邵 万	 U
绍 发	残 o
绍 家	残 a
舍 巴	 ぺ
舍 搬	 h
舍 串	 
舍 此	 
舍 得	 o
舍 的	 
舍 地	 a
舍 都	 常
舍 对	 癸
舍 恩	 
舍 尔	 焊
舍 费	 O
舍 夫	 ひ
舍 宫	 c
舍 海	 
舍 和	 M
舍 及	 の
舍 己	 v
舍 近	 
舍 就	 N
舍 克	 J
舍 勒	 扒
舍 雷	 p
舍 利	 Q
舍 瑞	 风
舍 身	 ō
舍 生	 ネ
舍 时	 
舍 是	 O
舍 说	 弧
舍 同	 P
舍 瓦	 ニ
舍 韦	 
舍 耶	 C
舍 已	 w
舍 在	 b
舍 镇	 马
舍 争	 
舍 中	 い
摄影家 单	尼va 虫
摄影家 久	尼va [
摄影家 们	尼va 
摄 出	尼 X
射出 的	gX 
射出 一	gX @
射手 并	gも }
涉 苏	A 默
社会党 签	婪|囊 帽
社会 发	婪| o
社员 家	拉 a
社 共	 @
社 签	 帽
设计家 万	]pa U
设计 并	]p }
设计 出	]p X
申报 并	ビ厨 }
申请 并	ビ叫 }
伸出 了	X F
伸出 手	X も
伸出 四	X |
伸张正义 并	iタq }
身体 并	ō砰 }
身 板	ō O
身 背	ō I
身 斗	ō 矮
身 丰	ō 伦
身 佩	ō ㄘ
深入浅出 地	`JLX a
神经学 家	g厩 a
神 采	 蹦
沈 家	H a
沈 坚	H 绊
沈 佩	H ㄘ
沈 树	H 攫
审查 并	fd }
审核 签	f 帽
审议 并	f某 }
审 并	f }
审 发	f o
甚至 万	痞 U
甚 丰	 伦
渗出 了	函X F
声明 签	n 帽
生产力 并	ネ玻O }
生产力 布	ネ玻O ガ
生产 并	ネ玻 }
生产 布	ネ玻 ガ
生产 出	ネ玻 X
生产 丰	ネ玻 伦
生产 共	ネ玻 @
生产 家	ネ玻 a
生出 带	ネX a
生出 隔	ネX j
生出 席	ネX u
生出 一	ネX @
生活状况 大	ネ―p j
生前 出	ネe X
生日 树	ネら 攫
生事 迹	ネㄆ 格
生死与共 的	ネ夯P@ 
生态学家 对	ネA厩a 癸
生态学家 谈	ネA厩a 酵
生物学家 还	ネ厩a 临
生物学家 威	ネ厩a 
生物 伦	ネ 
生猪 出	ネ睫 X
生 发	ネ o
生 丰	ネ 伦
生 树	ネ 攫
升格 而	ど τ
升格 和	ど M
升格 为	ど 
省长 共	侏 @
省政府 并	佻F┎ }
省政府 发	佻F┎ o
省政府 签	佻F┎ 帽
省 出	 X
省 丰	 伦
省 格	 
省 共	 @
省 秋	 
省 万	 U
盛况空前 的	脖p奴e 
盛 昂	脖 
盛 发	脖 o
盛 况	脖 p
盛 树	脖 攫
胜过 发	秤L o
胜 杯	秤 M
胜 伦	秤 
胜 佩	秤 ㄘ
胜 苏	秤 默
圣 伦	t 
师 涂	v 额
施行手术 的	I妞獬N 
施 出	I X
施 佩	I ㄘ
施 舍	I 
施 术	I N
施 托	I Λ
诗人 苏	钢H 默
诗 家	钢 a
十分 丰	Qだ 伦
十分 恼	Qだ o
十三 家	QT a
十万 彩	QU m
十万 大	QU j
十万 多	QU h
十万 个	QU 
十万 护	QU @
十万 计	QU p
十万 件	QU ン
十万 名	QU W
十万 亩	QU a
十万 人	QU H
十万 上	QU W
十万 头	QU Y
十万 项	QU 兜
十万 小	QU p
十万 余	QU E
十万 支	QU や
十万 字	QU r
十 发	Q o
十 家	Q a
石膏 板	ホI O
石匠 的	ホK 
石匠 砌	ホK 
石榴 树	ホh 攫
石头 并	ホY }
石油储量 丰	ホoxq 伦
石油输出国组织 成	ホo块X瓣舱麓 Θ
石油输出国组织 的	ホo块X瓣舱麓 
石油输出国组织 将	ホo块X瓣舱麓 N
石油输出国组织 上	ホo块X瓣舱麓 W
石油输出国组织 委	ホo块X瓣舱麓 e
石油输出国组织 在	ホo块X瓣舱麓 b
石 雕	ホ J
石 共	ホ @
石 家	ホ a
时间 共	啥 @
时 并	 }
时 发	 o
时 共	 @
时 签	 帽
什 布	ぐ ガ
什 出	ぐ X
什 共	ぐ @
什 伦	ぐ 
什 托	ぐ Λ
食品 共	公~ @
实际上 并	龟悔W }
实际 出	龟悔 X
实况 录	龟p 魁
实力 并	龟O }
实施 发	龟I o
实施 丰	龟I 伦
实体 并	龟砰 }
实行宵禁 的	龟娈dT 
实行 并	龟 }
实行 额	龟 B
实行 发	龟 o
实行 扶	龟 н
实行 共	龟 @
实行 佩	龟 ㄘ
实学 出	龟厩 X
实业家 龙	龟~a s
实 丰	龟 伦
实 秋	龟 
史学 家	v厩 a
史 并	v }
史 家	v a
使出 来	ㄏX ㄓ
使馆 共	ㄏ] @
使领馆 及	ㄏ烩] の
使用 并	ㄏノ }
使用 扶	ㄏノ н
使用 万	ㄏノ U
使 格	ㄏ 
使 家	ㄏ a
使 苏	ㄏ 默
使 万	ㄏ U
驶 出	p X
始 发	l o
式 并	Α }
式 出	Α X
示威者 并	ボ陋 }
士 共	h @
世家 的	@a 
世界纪录 并	@涩隹 }
世界 杯	@ M
世界 并	@ }
世 发	@ o
世 伦	@ 
世 乓	@ ャ
柿子 树	Ul 攫
事件 并	ㄆン }
事实 并	ㄆ龟 }
事务所 并	ㄆ叭┮ }
事务所 共	ㄆ叭┮ @
事务所 签	ㄆ叭┮ 帽
事务 共	ㄆ叭 @
事业 并	ㄆ~ }
事业 共	ㄆ~ @
事 并	ㄆ }
事 发	ㄆ o
事 迹	ㄆ 格
势力 并	墩O }
是非 婚	OD B
是否 丰	O_ 伦
是日 苏	Oら 默
是 板	O O
是 逼	O G
是 布	O ガ
是 采	O 蹦
是 出	O X
是 斗	O 矮
是 发	O o
是 丰	O 伦
是 扶	O н
是 格	O 
是 家	O a
是 坚	O 绊
是 漫	O 憨
是 佩	O ㄘ
是 秋	O 
是 苏	O 默
是 托	O Λ
是 万	O U
是 邢	O ǚ
适宜 采	Ay 蹦
适 树	A 攫
释放 并	睦 }
释放 出	睦 X
氏 杯	ん M
氏 熏	ん 饫
市场供应 丰	カ初ㄑ莱 伦
市场 并	カ初 }
市场 铲	カ初 藐
市场 出	カ初 X
市场 丰	カ初 伦
市长 布	カ ガ
市长 签	カ 帽
市长 万	カ U
市政府 签	カF┎ 帽
市 采	カ 蹦
市 发	カ o
市 丰	カ 伦
市 共	カ @
市 漫	カ 憨
市 舍	カ 
市 树	カ 攫
市 苏	カ 默
市 万	カ U
市 溪	カ 匪
视线 被	跌u Q
试车 并	刚ó }
试 采	刚 蹦
试 出	刚 X
收藏家 的	Μ旅a 
收藏家 们	Μ旅a 
收到 家	Μ a
收发 的	Μo 
收发 文	Μo ゅ
收复 苏	Μ_ 默
收购 额	Μ潦 B
收盘价格 为	ΜL基 
收入 并	ΜJ }
收入 共	ΜJ @
收益 额	Μq B
收支平衡 并	Μやキ颗 }
收 杯	Μ M
收 额	Μ B
收 托	Μ Λ
手背 上	もI W
手工艺 术	もu美 N
手工 焊	もu k
手迹 选	も格 匡
手脚 并	も} }
手术后 癌	もN 砾
手术后 的	もN 
手术后 仍	もN ご
手术后 无	もN L
手术后 用	もN ノ
手术台 前	もNx e
手术 从	もN q
手术 刀	もN M
手术 得	もN o
手术 的	もN 
手术 点	もN I
手术 费	もN O
手术 和	もN M
手术 还	もN 临
手术 救	もN 毕
手术 难	もN 螟
手术 尚	もN |
手术 时	もN 
手术 是	もN O
手术 已	もN w
手术 因	もN ]
手术 有	もN Τ
手术 在	もN b
手术 者	もN 
手术 中	もN い
手头紧 点	もY候 I
手头紧 一	もY候 @
手头 上	もY W
手头 拮	もY 
手 并	も }
手 布	も ガ
手 铲	も 藐
手 出	も X
手 扶	も н
手 共	も @
手 苏	も 默
首次 出	害 X
首次 签	害 帽
首都 布	撼 ガ
首都 出	撼 X
首都 苏	撼 默
首都 万	撼 U
首府 格	憨 
首先 出	亥 X
首先 发	亥 o
首相 杯	含 M
首 发	 o
首 家	 a
守 发	u o
寿 杯	关 M
授予 万	甭ぉ U
售货 额	扳f B
售票处 都	扳布B 常
售票处 走	扳布B ǐ
售 出	扳 X
受雇 于	侗 _
受贿 共	胳 @
受益 匪	q 
受 布	 ガ
蔬菜 采	江垫 蹦
梳妆 台	蕨 x
梳 出	 X
殊荣 的	砗a 
殊 死	 
抒 发	х o
输出 大	块X j
输出 的	块X 
输出 港	块X 翠
输出 国	块X 瓣
输出 纪	块X 
输出 渠	块X 措
输出 数	块X 计
输出 所	块X ┮
疏理 出	波z X
书法家 等	血ka 单
书法家 和	血ka M
书法家 将	血ka N
书法家 景	血ka 春
书法家 来	血ka ㄓ
书法家 李	血ka 
书法家 刘	血ka B
书法家 柳	血ka h
书法家 没	血ka S
书法家 能	血ka 
书法家 启	血ka 币
书法家 秦	血ka 
书法家 邱	血ka 
书法家 为	血ka 
书法家 越	血ka V
书画 家	训e a
书籍 共	涯y @
书记 板	寻O O
书记 发	寻O o
书记 邢	寻O ǚ
书家 信	旬a H
书面 发	循 o
书写 出	鸭g X
书 并	 }
书 出	 X
书 额	 B
书 共	 @
熟 采	剪 蹦
熟 丰	剪 伦
属国 际	妮瓣 悔
属国 家	妮瓣 a
属 家	妮 a
属 苏	妮 默
术语 过	Ny L
术语 来	Ny ㄓ
术 分	N だ
术 更	N 
术 和	N M
术 后	N 
术 前	N e
术 时	N 
术 式	N Α
术 是	N O
术 脱	N 叉
术 展	N i
术 中	N い
树干 上	攫F W
树根 的	攫 
树根 等	攫 单
树根 也	攫 ]
树立 必	攫ミ ゲ
树立 不	攫ミ ぃ
树立 的	攫ミ 
树立 个	攫ミ 
树立 过	攫ミ L
树立 好	攫ミ n
树立 和	攫ミ M
树立 俭	攫ミ 稽
树立 矿	攫ミ q
树立 良	攫ミ }
树立 了	攫ミ F
树立 柳	攫ミ h
树立 南	攫ミ n
树立 起	攫ミ _
树立 让	攫ミ 琵
树立 是	攫ミ O
树立 特	攫ミ S
树立 铁	攫ミ K
树立 统	攫ミ 参
树立 望	攫ミ 辨
树立 为	攫ミ 
树立 我	攫ミ и
树立 小	攫ミ p
树立 新	攫ミ s
树立 信	攫ミ H
树立 一	攫ミ @
树立 以	攫ミ H
树立 这	攫ミ o
树林 和	攫L M
树林 深	攫L `
树林 为	攫L 
树林 已	攫L w
树林 在	攫L b
树林 做	攫L 暗
树苗 不	攫] ぃ
树苗 的	攫] 
树苗 和	攫] M
树苗 后	攫] 
树苗 哪	攫] 
树苗 时	攫] 
树苗 要	攫] n
树木 被	攫れ Q
树木 长	攫れ 
树木 葱	攫れ 降
树木 的	攫れ 
树木 泛	攫れ x
树木 和	攫れ M
树木 砍	攫れ 
树木 乱	攫れ 睹
树木 排	攫れ 逼
树木 使	攫れ ㄏ
树木 刷	攫れ 
树木 园	攫れ 堕
树木 约	攫れ 
树皮 画	攫ブ e
树叶 的	攫腑 
树叶 上	攫腑 W
树叶 中	攫腑 い
树荫 走	攫疆 ǐ
树枝 上	攫K W
树枝 时	攫K 
树枝 下	攫K U
树枝 一	攫K @
树脂 包	攫 ]
树脂 成	攫 Θ
树脂 的	攫 
树脂 矿	攫 q
树 保	攫 O
树 备	攫 称
树 被	攫 Q
树 标	攫 夹
树 滨	攫 镭
树 藏	攫 旅
树 叉	攫 e
树 长	攫 
树 成	攫 Θ
树 村	攫 
树 代	攫 N
树 的	攫 
树 等	攫 单
树 低	攫 C
树 洞	攫 }
树 都	攫 常
树 对	攫 癸
树 多	攫 h
树 芳	攫 
树 房	攫 ┬
树 副	攫 捌
树 高	攫 蔼
树 挂	攫 本
树 冠	攫 a
树 广	攫 s
树 海	攫 
树 航	攫 
树 和	攫 M
树 红	攫 
树 护	攫 @
树 花	攫 
树 还	攫 临
树 黄	攫 独
树 及	攫 の
树 见	攫 ǎ
树 将	攫 N
树 街	攫 刁
树 径	攫 |
树 就	攫 N
树 砍	攫 
树 坑	攫 |
树 腊	攫 镁
树 啦	攫 罢
树 来	攫 ㄓ
树 兰	攫 孽
树 老	攫 ρ
树 梨	攫 冰
树 良	攫 }
树 了	攫 F
树 龄	攫 闹
树 岭	攫 拉
树 满	攫 骸
树 门	攫 
树 迷	攫 g
树 名	攫 W
树 难	攫 螟
树 培	攫 蚌
树 品	攫 ~
树 平	攫 キ
树 七	攫 C
树 起	攫 _
树 强	攫 j
树 青	攫 C
树 琼	攫 茫
树 权	攫 v
树 群	攫 s
树 仁	攫 く
树 如	攫 p
树 森	攫 此
树 上	攫 W
树 少	攫 ぶ
树 使	攫 ㄏ
树 是	攫 O
树 手	攫 も
树 说	攫 弧
树 随	攫 H
树 庭	攫 x
树 桐	攫 
树 同	攫 P
树 捅	攫 讯
树 挽	攫 
树 万	攫 U
树 威	攫 
树 为	攫 
树 未	攫 ゼ
树 稀	攫 }
树 下	攫 U
树 县	攫 郡
树 新	攫 s
树 信	攫 H
树 兴	攫 砍
树 学	攫 厩
树 勋	攫 吃
树 言	攫 ē
树 耀	攫 模
树 也	攫 ]
树 业	攫 ~
树 一	攫 @
树 已	攫 w
树 应	攫 莱
树 用	攫 ノ
树 有	攫 Τ
树 于	攫 _
树 远	攫 环
树 栽	攫 
树 在	攫 b
树 只	攫 u
树 种	攫 贺
树 转	攫 锣
树 籽	攫 
树 蓊	攫 c
树 楠	攫 罚
树 铎	攫 M
竖起 的	捷_ 
竖起 了	捷_ F
竖 板	捷 O
数额 百	计B κ
数额 达	计B F
数额 大	计B j
数额 的	计B 
数额 对	计B 癸
数额 很	计B 
数额 将	计B N
数额 较	计B 耕
数额 尚	计B |
数额 为	计B 
数额 要	计B n
数额 也	计B ]
数额 应	计B 莱
数额 由	计B パ
数额 之	计B ぇ
数额 逐	计B v
数落 出	计辅 X
数学家 的	计厩a 
数学家 张	计厩a i
数字 并	计r }
数 家	计 a
数 万	计 U
衰退 并	Ih }
甩 出	ハ X
帅 家	 a
霜 斗	流 矮
双边贸易 额	蛮娩T B
双方 共	蛮よ @
双方 签	蛮よ 帽
双手 发	蛮も o
双手 托	蛮も Λ
双 杯	蛮 M
双 雕	蛮 J
双 发	蛮 o
双 丰	蛮 伦
双 万	蛮 U
谁 家	街 a
水草 丰	舣 伦
水稻 丰	艚_ 伦
水果 布	舄G ガ
水果 丰	舄G 伦
水利 共	臾Q @
水力发电 成	簸Ooq Θ
水力发电 的	簸Ooq 
水轮发电机 组	艚oq诀 舱
水泥 板	舄d O
水桶 为	舯 
水桶 用	舯 ノ
水土保持 的	簸gO 
水土保持 法	簸gO k
水土保持 和	簸gO M
水土保持 林	簸gO L
水土保持 效	簸gO 
水土流失 的	簸gyア 
水土流失 和	簸gyア M
水土流失 后	簸gyア 
水土流失 或	簸gyア ┪
水土流失 量	簸gyア q
水土流失 使	簸gyア ㄏ
水土流失 这	簸gyア o
水退 堤	舭h 出
水 发	 o
水 丰	 伦
水 共	 @
水 家	 a
水 漫	 憨
税额 为	|B 
税额 由	|B パ
税 共	| @
瞬息 万	俐 U
瞬 发	俐 o
顺差 额	抖t B
顺差 共	抖t @
顺 扶	抖 н
说出 几	弧X X
说出 了	弧X F
说出 一	弧X @
说法 并	弧k }
斯 杯	吹 M
斯 并	吹 }
斯 布	吹 ガ
斯 出	吹 X
斯 佩	吹 ㄘ
斯 签	吹 帽
斯 秋	吹 
斯 托	吹 Λ
斯 珀	吹 
思潮 的	浼 
思潮 和	浼 M
思潮 就	浼 N
思潮 来	浼 ㄓ
思潮 是	浼 O
思潮 一	浼 @
思潮 在	浼 b
思潮 作	浼 @
思想家 和	浞Qa M
思想家 说	浞Qa 弧
思想 坚	浞Q 绊
思绪 万	浜 U
私营企业 家	p犁~ a
司机 出	q诀 X
死者家属 被	邯坍a妮 Q
死者家属 怀	邯坍a妮 h
死者 家	邯 a
四川 万	|t U
四个坚持 与	|影慝 P
四 杯	| M
四 出	| X
四 家	| a
似乎 并	G }
似 发	 o
松 发	P o
松 树	P 攫
松 苏	P 默
送出 的	eX 
送出 站	eX 
送到 布	e ガ
送到 家	e a
送回 昂	e^ 
送回 家	e^ a
送 发	e o
送 秋	e 
宋 丰	Ш 伦
宋 家	Ш a
宋 树	Ш 攫
搜查 并	jd }
搜集 并	j栋 }
搜 出	j X
苏打水 瓶	默ゴ ~
苏丹 镑	默う 麻
苏丹 草	默う 
苏丹 反	默う は
苏丹 和	默う M
苏丹 境	默う 挂
苏丹 卡	默う d
苏丹 人	默う H
苏丹 所	默う ┮
苏丹 通	默う q
苏丹 也	默う ]
苏丹 驻	默う n
苏俄 罗	默X 霉
苏格兰 的	默婺 
苏格兰 队	默婺 钉
苏格兰 格	默婺 
苏格兰 各	默婺 U
苏格兰 硅	默婺 趾
苏格兰 圣	默婺 t
苏格兰 台	默婺 x
苏格兰 小	默婺 p
苏联 阿	默p 
苏联 艾	默p 
苏联 奥	默p 而
苏联 把	默p р
苏联 本	默p セ
苏联 别	默p O
苏联 滨	默p 镭
苏联 冰	默p B
苏联 不	默p ぃ
苏联 布	默p ガ
苏联 采	默p 蹦
苏联 敞	默p 疮
苏联 成	默p Θ
苏联 赤	默p í
苏联 出	默p X
苏联 从	默p q
苏联 带	默p a
苏联 党	默p 囊
苏联 的	默p 
苏联 等	默p 单
苏联 第	默p 材
苏联 冻	默p 
苏联 队	默p 钉
苏联 对	默p 癸
苏联 顿	默p y
苏联 多	默p h
苏联 俄	默p X
苏联 而	默p τ
苏联 发	默p o
苏联 赴	默p u
苏联 副	默p 捌
苏联 该	默p 赣
苏联 戈	默p む
苏联 各	默p U
苏联 共	默p @
苏联 关	默p 闽
苏联 和	默p M
苏联 红	默p 
苏联 后	默p 
苏联 还	默p 临
苏联 会	默p |
苏联 或	默p ┪
苏联 极	默p 伐
苏联 及	默p の
苏联 检	默p 浪
苏联 建	默p 
苏联 将	默p N
苏联 接	默p 钡
苏联 境	默p 挂
苏联 就	默p N
苏联 军	默p x
苏联 开	默p }
苏联 可	默p i
苏联 两	默p ㄢ
苏联 列	默p C
苏联 六	默p せ
苏联 曼	默p 耙
苏联 忙	默p Γ
苏联 每	默p C
苏联 盟	默p 幅
苏联 明	默p 
苏联 那	默p ê
苏联 南	默p n
苏联 男	默p k
苏联 能	默p 
苏联 女	默p k
苏联 洽	默p 
苏联 签	默p 帽
苏联 前	默p e
苏联 欠	默p ろ
苏联 全	默p 
苏联 人	默p H
苏联 是	默p O
苏联 说	默p 弧
苏联 斯	默p 吹
苏联 塔	默p 娥
苏联 同	默p P
苏联 土	默p g
苏联 外	默p ~
苏联 为	默p 
苏联 无	默p L
苏联 五	默p き
苏联 系	默p t
苏联 向	默p V
苏联 新	默p s
苏联 亚	默p ㄈ
苏联 也	默p ]
苏联 一	默p @
苏联 已	默p w
苏联 因	默p ]
苏联 有	默p Τ
苏联 与	默p P
苏联 宇	默p t
苏联 约	默p 
苏联 在	默p b
苏联 则	默p h
苏联 曾	默p 纯
苏联 扎	默p 蚕
苏联 站	默p 
苏联 这	默p o
苏联 正	默p タ
苏联 之	默p ぇ
苏联 驻	默p n
苏联 准	默p 
苏联 最	默p 程
苏联 作	默p @
苏木 巴	默れ ぺ
苏木 镇	默れ 马
苏维埃 不	默蝴J ぃ
苏维埃 的	默蝴J 
苏维埃 对	默蝴J 癸
苏维埃 俄	默蝴J X
苏维埃 关	默蝴J 闽
苏维埃 和	默蝴J M
苏维埃 还	默蝴J 临
苏维埃 就	默蝴J N
苏维埃 两	默蝴J ㄢ
苏维埃 新	默蝴J s
苏维埃 于	默蝴J _
苏维埃 在	默蝴J b
苏维埃 执	默蝴J 磅
苏醒 了	默眶 F
苏伊士运河 的	默レhBe 
苏伊士运河 是	默レhBe O
苏州 城	默{ 
苏州 等	默{ 单
苏州 和	默{ M
苏州 河	默{ e
苏州 红	默{ 
苏州 街	默{ 刁
苏州 京	默{ ㄊ
苏州 梅	默{ 宾
苏州 培	默{ 蚌
苏州 轻	默{ 淮
苏州 人	默{ H
苏州 市	默{ カ
苏州 游	默{ 村
苏州 有	默{ Τ
苏 阿	默 
苏 艾	默 
苏 奥	默 而
苏 巴	默 ぺ
苏 把	默 р
苏 百	默 κ
苏 保	默 O
苏 北	默 _
苏 贝	默 ī
苏 比	默 ゑ
苏 边	默 娩
苏 布	默 ガ
苏 步	默 B
苏 草	默 
苏 传	默 肚
苏 从	默 q
苏 大	默 j
苏 德	默 w
苏 的	默 
苏 等	默 单
苏 蒂	默 甫
苏 第	默 材
苏 都	默 常
苏 对	默 癸
苏 尔	默 焊
苏 发	默 o
苏 法	默 k
苏 方	默 よ
苏 菲	默 滇
苏 副	默 捌
苏 各	默 U
苏 共	默 @
苏 古	默 j
苏 关	默 闽
苏 光	默 
苏 归	默 k
苏 国	默 瓣
苏 哈	默 
苏 韩	默 龙
苏 航	默 
苏 和	默 M
苏 赫	默 划
苏 红	默 
苏 厚	默 p
苏 后	默 
苏 惠	默 f
苏 获	默 莉
苏 吉	默 N
苏 及	默 の
苏 纪	默 
苏 家	默 a
苏 贾	默 鸽
苏 健	默 胺
苏 将	默 N
苏 杰	默 城
苏 捷	默 倍
苏 经	默 g
苏 静	默 R
苏 境	默 挂
苏 就	默 N
苏 局	默 Ы
苏 军	默 x
苏 开	默 }
苏 克	默 J
苏 拉	默 ┰
苏 莱	默 弟
苏 来	默 ㄓ
苏 老	默 ρ
苏 里	默 
苏 立	默 ミ
苏 两	默 ㄢ
苏 鲁	默 |
苏 伦	默 
苏 罗	默 霉
苏 洛	默 
苏 麦	默 沉
苏 貌	默 华
苏 美	默 
苏 蒙	默 X
苏 明	默 
苏 睦	默 伏
苏 纳	默 
苏 南	默 n
苏 能	默 
苏 女	默 k
苏 欧	默 稼
苏 培	默 蚌
苏 平	默 キ
苏 普	默 炊
苏 区	默 跋
苏 权	默 v
苏 日	默 ら
苏 萨	默 履
苏 三	默 T
苏 珊	默 
苏 陕	默 阿
苏 尚	默 |
苏 时	默 
苏 叔	默 
苏 双	默 蛮
苏 顺	默 抖
苏 斯	默 吹
苏 四	默 |
苏 特	默 S
苏 廷	默 
苏 土	默 g
苏 瓦	默 ニ
苏 威	默 
苏 维	默 蝴
苏 武	默 Z
苏 五	默 き
苏 锡	默 奎
苏 县	默 郡
苏 向	默 V
苏 匈	默 I
苏 亚	默 ㄈ
苏 研	默 
苏 一	默 @
苏 移	默 簿
苏 已	默 w
苏 以	默 H
苏 意	默 N
苏 英	默 ^
苏 应	默 莱
苏 有	默 Τ
苏 于	默 _
苏 与	默 P
苏 宇	默 t
苏 原	默 
苏 在	默 b
苏 则	默 h
苏 扎	默 蚕
苏 制	默 
苏 中	默 い
苏 仲	默 ヲ
苏 驻	默 n
苏 子	默 l
苏 最	默 程
苏 桦	默 眷
素昧平生 的	垃Nキネ 
塑料 板	鹅 O
塑料 布	鹅 ガ
塑像 敬	鹅钩 q
塑造 出	鹅y X
宿舍 挨	J 
宿舍 的	J 
宿舍 地	J a
宿舍 都	J 常
宿舍 共	J @
宿舍 和	J M
宿舍 离	J 瞒
宿舍 里	J 
宿舍 楼	J 加
宿舍 区	J 跋
宿舍 是	J O
宿舍 一	J @
宿舍 院	J |
宿舍 中	J い
肃立 默	德ミ q
算 出	衡 X
算 家	衡 a
虽然 并	瘤M }
随时 并	H }
随同 万	HP U
随著 发	H帝 o
随 发	H o
岁 杯	烦 M
岁 发	烦 o
孙 家	] a
孙 敬	] q
孙 树	] 攫
损失 并	lア }
损失 额	lア B
损失 共	lア @
损 共	l @
索 布	 ガ
索 出	 X
索 格	 
索 托	 Λ
索 溪	 匪
所以 布	┮H ガ
所有 苏	┮Τ 默
所 发	┮ o
所 共	┮ @
所 签	┮ 帽
所 托	┮ Λ
塌方 的	厄よ 
塌陷 区	厄炒 跋
塌 的	厄 
塌 顶	厄 郴
塌 了	厄 F
塌 落	厄 辅
塌 上	厄 W
他们 背	L I
他们 逼	L G
他们 并	L }
他们 出	L X
他们 发	L o
他们 共	L @
他们 汲	L V
他们 家	L a
他们 敬	L q
他们 舍	L 
他 背	L I
他 并	L }
他 出	L X
他 发	L o
他 扶	L н
他 共	L @
他 家	L a
他 敬	L q
他 婉	L 胞
它的 疗	ウ 励
它 并	ウ }
它 共	ウ @
她们 家	o a
她 背	o I
她 并	o }
她 出	o X
她 发	o o
她 婚	o B
她 家	o a
她 敬	o q
她 扑	o 汲
她 舍	o 
塔 格	娥 
塔 默	娥 q
踏步走 上	今Bǐ W
踏步 不	今B ぃ
抬头 并	╋Y }
抬 出	╋ X
台湾 并	xW }
台 布	x ガ
台 发	x o
台 共	x @
泰 斗	 矮
泰 苏	 默
太太 凄	びび Y
太阳能 采	び锭 蹦
太阳 杯	び锭 M
态 万	A U
坍 塌	~ 厄
摊 出	u X
滩 背	y I
滩 涂	y 额
痰 迹	佛 格
潭 杯	兼 M
谭 家	糜 a
谈判 并	酵P }
谈 出	酵 X
谈 家	酵 a
谈 苏	酵 默
坦诚 布	Z港 ガ
坦克 并	ZJ }
坦 并	Z }
坦 布	Z ガ
探测 出	贝代 X
探索 并	贝 }
探索 出	贝 X
探讨 并	贝Q }
探讨 签	贝Q 帽
探 家	贝 a
汤杯 半	傣M b
汤杯 和	傣M M
塘 背	俄 I
塘 格	俄 
唐 布	 ガ
唐 家	 a
唐 树	 攫
糖尿病 并	}Эf }
淌出 来	IX ㄓ
趟 家	诫 a
烫 发	S o
掏出 本	鼻X セ
掏出 厚	鼻X p
掏出 那	鼻X ê
掏出 钱	鼻X 窥
掏出 一	鼻X @
掏出 这	鼻X o
滔滔 溪	肥肥 匪
桃 家	 a
逃 出	k X
淘汰 出	^O X
讨论会 并	Q阶| }
讨论 并	Q阶 }
讨论 发	Q阶 o
讨论 签	Q阶 帽
讨论 苏	Q阶 默
讨 并	Q }
套 并	M }
套 出	M X
套 丰	M 伦
套 共	M @
特别奖 杯	SO贱 M
特使 布	Sㄏ ガ
特殊 奥	S 而
特殊 标	S 夹
特殊 病	S f
特殊 的	S 
特殊 而	S τ
特殊 干	S F
特殊 钢	S 葵
特殊 构	S c
特殊 关	S 闽
特殊 和	S M
特殊 护	S @
特殊 疗	S 励
特殊 论	S 阶
特殊 清	S M
特殊 险	S I
特殊 性	S ┦
特殊 优	S u
特殊 葬	S 府
特殊 凿	S w
特 杯	S M
特 格	S 
特 伦	S 
特 万	S U
腾出 部	乃X 场
腾出 两	乃X ㄢ
腾出 了	乃X F
腾出 一	乃X @
腾 格	乃 
踢出 的	金X 
踢出 一	金X @
提案 共	矗 @
提倡 并	矗 }
提出 按	矗X 
提出 把	矗X р
提出 办	矗X 快
提出 北	矗X _
提出 并	矗X }
提出 不	矗X ぃ
提出 朝	矗X 绰
提出 到	矗X 
提出 的	矗X 
提出 订	矗X q
提出 对	矗X 癸
提出 多	矗X h
提出 泛	矗X x
提出 分	矗X だ
提出 扶	矗X н
提出 复	矗X _
提出 各	矗X U
提出 给	矗X 倒
提出 更	矗X 
提出 关	矗X 闽
提出 过	矗X L
提出 和	矗X M
提出 很	矗X 
提出 后	矗X 
提出 或	矗X ┪
提出 几	矗X X
提出 将	矗X N
提出 近	矗X 
提出 尽	矗X 荷
提出 举	矗X |
提出 开	矗X }
提出 来	矗X ㄓ
提出 离	矗X 瞒
提出 力	矗X O
提出 两	矗X ㄢ
提出 了	矗X F
提出 六	矗X せ
提出 美	矗X 
提出 派	矗X 
提出 七	矗X C
提出 签	矗X 帽
提出 取	矗X 
提出 全	矗X 
提出 让	矗X 琵
提出 三	矗X T
提出 商	矗X 坝
提出 上	矗X W
提出 审	矗X f
提出 使	矗X ㄏ
提出 试	矗X 刚
提出 四	矗X |
提出 抬	矗X ╋
提出 同	矗X P
提出 统	矗X 参
提出 头	矗X Y
提出 为	矗X 
提出 五	矗X き
提出 西	矗X 
提出 下	矗X U
提出 先	矗X 
提出 向	矗X V
提出 新	矗X s
提出 心	矗X み
提出 选	矗X 匡
提出 学	矗X 厩
提出 要	矗X n
提出 一	矗X @
提出 伊	矗X レ
提出 以	矗X H
提出 议	矗X 某
提出 应	矗X 莱
提出 用	矗X ノ
提出 由	矗X パ
提出 与	矗X P
提出 在	矗X b
提出 这	矗X o
提出 正	矗X タ
提出 只	矗X u
提出 周	矗X P
提出 最	矗X 程
提高 并	矗蔼 }
提高 采	矗蔼 蹦
提高 出	矗蔼 X
提供 出	矗ㄑ X
提供 扶	矗ㄑ н
提炼 出	矗芬 X
提 格	矗 
题诗 一	D钢 @
体外受精 的	砰~弘 
体验 到	砰喷 
体验 等	砰喷 单
体验 过	砰喷 L
体验 和	砰喷 M
体验 就	砰喷 N
体验 农	砰喷 A
体育 杯	砰| M
体育 并	砰| }
体 并	砰 }
体 采	砰 蹦
剃 得	c o
剃 光	c 
天花板 掉	ぱ岐O 奔
天然 树	ぱM 攫
天天 逼	ぱぱ G
天文学家 丹	ぱゅ厩a う
天文学家 们	ぱゅ厩a 
天文学家 欣	ぱゅ厩a Y
天文学家 在	ぱゅ厩a b
天真烂漫 的	ぱu年憨 
天 出	ぱ X
天 斗	ぱ 矮
天 丰	ぱ 伦
天 签	ぱ 帽
填 发	恶 o
田家 庄	バa 缠
田 敬	バ q
田 万	バ U
挑选 出	D匡 X
挑战者 聂	D驹 驴
挑战者 是	D驹 O
挑战者 谢	D驹 谅
挑战 便	D驹 K
挑战 不	D驹 ぃ
挑战 的	D驹 
挑战 而	D驹 τ
挑战 呢	D驹 O
挑战 权	D驹 v
挑战 赛	D驹 辽
挑战 是	D驹 O
挑战 性	D驹 ┦
挑战 需	D驹 惠
挑战 也	D驹 ]
挑战 与	D驹 P
挑战 之	D驹 ぇ
挑 出	D X
条文 并	兵ゅ }
条 布	兵 ガ
条 扶	兵 н
条 格	兵 
条 共	兵 @
条 溪	兵 匪
跳板跳水 中	铬O铬 い
跳板 的	铬O 
跳板 等	铬O 单
跳板 和	铬O M
跳板 前	铬O e
跳出 个	铬X 
跳出 会	铬X |
跳出 了	铬X F
跳 背	铬 I
贴 出	K X
铁路局 共	K隔Ы @
铁路隧道 锚	K隔GD 零
铁路 共	K隔 @
铁路 万	K隔 U
铁 布	K ガ
铁 家	K a
听取 并	钮 }
听说 出	钮弧 X
听 出	钮 X
廷 比	 ゑ
廷 等	 单
廷 光	 
廷 贵	 Q
廷 海	 
廷 和	 M
廷 克	 J
廷 茂	 Z
廷 模	 家
廷 奶	 イ
廷 说	 弧
廷 斯	 吹
廷 松	 P
廷 祥	 不
廷 孝	 У
廷 雅	 懂
廷 元	 じ
廷 远	 环
廷 在	 b
廷 楣	 钒
停止 迹	氨ゎ 格
停 并	氨 }
停 发	氨 o
亭 家	F a
庭院 树	x| 攫
挺身而出 把	绩τX р
挺 丰	 伦
通过 并	qL }
通过 家	qL a
通讯社 发	qT o
通 杯	q M
通 并	q }
通 万	q U
同甘共苦 的	Pヌ@W 
同盟 并	P幅 }
同时发行 白	P傻o フ
同时发行 一	P傻o @
同学 发	P厩 o
同学 家	P厩 a
同意 昂	PN 
同意 布	PN ガ
同意 签	PN 帽
同意 苏	PN 默
同志 背	Pв I
同志 并	Pв }
同志 出	Pв X
同志 发	Pв o
同志 共	Pв @
同舟共济 的	P唳@蕾 
同 布	P ガ
同 出	P X
同 发	P o
同 家	P a
同 佩	P ㄘ
同 签	P 帽
同 树	P 攫
同 苏	P 默
铜板 都	簧O 常
童 帽	担 U
童 万	担 U
统一 并	参@ }
痛苦 万	hW U
投出 一	щX @
投入 扑	щJ 汲
投书 万	щ U
投资 并	щ戈 }
投资 额	щ戈 B
投资 共	щ戈 @
头衔 并	Y晃 }
头 并	Y }
头 出	Y X
头 发	Y o
头 佩	Y ㄘ
头 扑	Y 汲
头 万	Y U
透露 出	zS X
透露 苏	zS 默
透视 出	z跌 X
透 出	z X
秃 发	r o
突出 波	馥X i
突出 成	馥X Θ
突出 从	馥X q
突出 的	馥X 
突出 地	馥X a
突出 扶	馥X н
突出 和	馥X M
突出 就	馥X N
突出 了	馥X F
突出 龙	馥X s
突出 是	馥X O
突出 效	馥X 
突出 症	馥X g
突出 抓	馥X ъ
突击队 共	鹄欢 @
突破 万	鸠} U
突然 发	鸬M o
突然 塌	鸬M 厄
突 并	 }
突 发	 o
图书 托	瓜 Λ
图像 并	瓜钩 }
图 格	瓜 
途径 并	~| }
涂改 和	额э M
涂料 厂	额 t
涂料 是	额 O
涂料 在	额 b
涂抹 这	额┵ o
涂抹 制	额┵ 
涂油 井	额o か
涂 层	额 h
涂 长	额 
涂 粉	额 
涂 和	额 M
涂 划	额 购
涂 胶	额 溅
涂 军	额 x
涂 乱	额 睹
涂 面	额 
涂 养	额 i
涂 有	额 Τ
涂 友	额 ね
屠 格	O 
土地 共	ga @
土生土长 并	gネg }
土 并	g }
土 家	g a
土 伦	g 
土 默	g q
土 签	g 帽
土 苏	g 默
吐出 的	RX 
吐出 了	RX F
兔 帽	ㄟ U
团体 共	刮砰 @
团 共	刮 @
团 树	刮 攫
推出 崔	崩X Z
推出 带	崩X a
推出 的	崩X 
推出 短	崩X u
推出 多	崩X h
推出 高	崩X 蔼
推出 更	崩X 
推出 共	崩X @
推出 基	崩X 膀
推出 了	崩X F
推出 去	崩X h
推出 数	崩X 计
推出 它	崩X ウ
推出 维	崩X 蝴
推出 西	崩X 
推出 新	崩X s
推出 一	崩X @
推出 这	崩X o
推翻 布	崩陆 ガ
推广 并	崩s }
推广 扶	崩s н
推进 并	崩i }
推举 出	崩| X
推销 出	崩P X
推行 扶	崩 н
推行 共	崩 @
推行 敬	崩 q
推选 布	崩匡 ガ
推选 出	崩匡 X
腿 并	L }
退出 本	hX セ
退出 的	hX 
退出 华	hX 地
退出 经	hX g
退出 了	hX F
退出 男	hX k
退出 女	hX k
退出 全	hX 
退出 沙	hX F
退出 宅	hX v
退休 并	hヰ }
退役 并	h }
吞 并	] }
拖 家	╈ a
托儿所 和	Λㄠ┮ M
托儿所 难	Λㄠ┮ 螟
托儿所 也	Λㄠ┮ ]
托付 给	ΛI 倒
托管 地	Λ恨 a
托管 和	Λ恨 M
托管 局	Λ恨 Ы
托著 徐	Λ帝 }
托著 银	Λ帝 蝗
托 哀	Λ s
托 按	Λ 
托 报	Λ 厨
托 本	Λ セ
托 毕	Λ 拨
托 不	Λ ぃ
托 产	Λ 玻
托 出	Λ X
托 茨	Λ 
托 到	Λ 
托 德	Λ w
托 的	Λ 
托 队	Λ 钉
托 对	Λ 癸
托 多	Λ h
托 儿	Λ ㄠ
托 尔	Λ 焊
托 法	Λ k
托 方	Λ よ
托 菲	Λ 滇
托 费	Λ O
托 夫	Λ ひ
托 弗	Λ ケ
托 赴	Λ u
托 副	Λ 捌
托 该	Λ 赣
托 给	Λ 倒
托 供	Λ ㄑ
托 海	Λ 
托 邯	Λ 驼
托 和	Λ M
托 后	Λ 
托 乎	Λ G
托 回	Λ ^
托 基	Λ 膀
托 季	Λ u
托 加	Λ [
托 将	Λ N
托 焦	Λ J
托 就	Λ N
托 局	Λ Ы
托 卡	Λ d
托 科	Λ 
托 克	Λ J
托 拉	Λ ┰
托 来	Λ ㄓ
托 雷	Λ p
托 李	Λ 
托 里	Λ 
托 利	Λ Q
托 连	Λ s
托 链	Λ 渺
托 了	Λ F
托 林	Λ L
托 伦	Λ 
托 洛	Λ 
托 马	Λ 皑
托 毛	Λ を
托 门	Λ 
托 姆	Λ i
托 木	Λ れ
托 那	Λ ê
托 纳	Λ 
托 尼	Λ ェ
托 努	Λ V
托 棋	Λ 囱
托 起	Λ _
托 亲	Λ 克
托 去	Λ h
托 人	Λ H
托 三	Λ T
托 省	Λ 
托 是	Λ O
托 市	Λ カ
托 收	Λ Μ
托 书	Λ 
托 说	Λ 弧
托 斯	Λ 吹
托 思	Λ 
托 所	Λ ┮
托 他	Λ L
托 艇	Λ 弗
托 同	Λ P
托 娃	Λ 
托 瓦	Λ ニ
托 王	Λ 
托 我	Λ и
托 向	Λ V
托 也	Λ ]
托 一	Λ @
托 伊	Λ レ
托 以	Λ H
托 幼	Λ ギ
托 于	Λ _
托 与	Λ P
托 运	Λ B
托 在	Λ b
托 之	Λ ぇ
托 中	Λ い
托 砖	Λ j
托 兹	Λ 
托 娅	Λ 哉
脱离 并	叉瞒 }
脱颖而出 成	叉oτX Θ
脱颖而出 的	叉oτX 
脱 发	叉 o
驼背 鹦	mI x
驼背 鲈	mI t
妥协 并	Т }
挖掘 出	醣 X
挖 采	 蹦
挖 出	 X
挖 树	 攫
娃 杯	 M
瓦 格	ニ 
瓦 伦	ニ 
瓦 舍	ニ 
外长 布	~ ガ
外长 格	~ 
外长 佩	~ ㄘ
外出 拜	~X 
外出 办	~X 快
外出 的	~X 
外出 干	~X F
外出 揽	~X 朋
外出 捞	~X 即
外出 旅	~X 
外出 民	~X チ
外出 前	~X e
外出 坐	~X Г
外国 签	~瓣 帽
外汇 并	~蹲 }
外汇 额	~蹲 B
外汇 托	~蹲 Λ
外交部 苏	~ユ场 默
外交家 蒂	~ユa 甫
外交家 应	~ユa 莱
外交家 曾	~ユa 纯
外来 的	~ㄓ 
外来 干	~ㄓ F
外来 兼	~ㄓ 
外来 水	~ㄓ 
外来 新	~ㄓ s
外来 油	~ㄓ o
外贸 额	~T B
外债 额	~杜 B
外资 额	~戈 B
外 伦	~ 
湾 并	W }
玩耍 时	杯A 
顽强 斗	xj 矮
完毕 并	Ч拨 }
完毕 的	Ч拨 
完毕 时	Ч拨 
完成 并	ЧΘ }
完成 额	ЧΘ B
完成 发	ЧΘ o
完成 共	ЧΘ @
完稿 并	ЧZ }
完了 家	ЧF a
完全 出	Ч X
完善 并	Ч到 }
挽救 了	颈 F
挽救 数	颈 计
皖 苏	p 默
婉 婉	胞 胞
万分 地	Uだ a
万分 之	Uだ ぇ
万国 铭	U瓣 皇
万国 权	U瓣 v
万花 乡	U m
万花 油	U o
万家灯火 在	UaO b
万里长城 上	U姜 W
万里长空 象	U姜 H
万年 常	U~ `
万年 长	U~ 
万年 的	U~ 
万年 讲	U~ 量
万年 经	U~ g
万年 随	U~ H
万年 心	U~ み
万年 在	U~ b
万年 之	U~ ぇ
万人空巷 式	UH奴 Α
万人 被	UH Q
万人 扯	UH ц
万人 成	UH Θ
万人 冲	UH R
万人 次	UH Ω
万人 打	UH ゴ
万人 的	UH 
万人 喝	UH 耻
万人 和	UH M
万人 卷	UH 
万人 开	UH }
万人 口	UH f
万人 呢	UH O
万人 丧	UH 赤
万人 无	UH L
万人 行	UH 
万人 游	UH 村
万人 在	UH b
万人 中	UH い
万人 祝	UH 
万向节 厂	UV` t
万象更新 的	UH蠓s 
万象 后	UH 
万象 瓦	UH ニ
万一 喝	U@ 耻
万一 人	U@ H
万一 有	U@ Τ
万众一心 的	U渤@み 
万紫千红 奖	U档d 贱
万 把	U р
万 宝	U _
万 变	U 跑
万 彬	U l
万 波	U i
万 博	U 痴
万 不	U ぃ
万 册	U U
万 长	U 
万 城	U 
万 成	U Θ
万 春	U K
万 次	U Ω
万 代	U N
万 担	U 踞
万 党	U 囊
万 道	U D
万 的	U 
万 滴	U w
万 点	U I
万 端	U 狠
万 多	U h
万 朵	U Ψ
万 儿	U ㄠ
万 方	U よ
万 份	U 
万 封	U 
万 伏	U ヱ
万 福	U 褐
万 港	U 翠
万 高	U 蔼
万 个	U 
万 各	U U
万 古	U j
万 海	U 
万 航	U 
万 毫	U @
万 好	U n
万 亨	U 
万 户	U め
万 辉	U 谨
万 计	U p
万 家	U a
万 加	U [
万 间	U 丁
万 减	U 搭
万 件	U ン
万 杰	U 城
万 景	U 春
万 卷	U 
万 棵	U 词
万 颗	U 聋
万 块	U 遏
万 里	U 
万 例	U ㄒ
万 良	U }
万 两	U ㄢ
万 辆	U 进
万 岭	U 拉
万 鹿	U 忱
万 绿	U 厚
万 枚	U T
万 蒙	U X
万 米	U μ
万 民	U チ
万 明	U 
万 名	U W
万 亩	U a
万 木	U れ
万 尼	U ェ
万 宁	U 圭
万 农	U A
万 女	U k
万 诺	U 空
万 匹	U で
万 偏	U 熬
万 票	U 布
万 瓶	U ~
万 千	U d
万 顷	U 臣
万 泉	U u
万 润	U 柬
万 赛	U 辽
万 山	U s
万 商	U 坝
万 少	U ぶ
万 绍	U 残
万 生	U ネ
万 石	U ホ
万 事	U ㄆ
万 是	U O
万 视	U 跌
万 寿	U 关
万 树	U 攫
万 双	U 蛮
万 说	U 弧
万 嗣	U 多
万 台	U x
万 套	U M
万 提	U 矗
万 通	U q
万 头	U Y
万 万	U U
万 祥	U 不
万 项	U 兜
万 谢	U 谅
万 新	U s
万 兴	U 砍
万 行	U 
万 言	U ē
万 应	U 莱
万 游	U 村
万 友	U ね
万 余	U E
万 源	U 方
万 载	U 更
万 在	U b
万 盏	U 辐
万 章	U 彻
万 张	U i
万 兆	U 
万 支	U や
万 职	U 戮
万 只	U u
万 中	U い
万 种	U 贺
万 众	U 渤
万 株	U 
万 壮	U Ё
万 状	U 
万 字	U r
万 壑	U 坤
万 琦	U a
万 祺	U R
万 铢	U 凰
万 籁	U 牛
汪 家	L a
王家 队	a 钉
王家 看	a 
王家 坪	a W
王子 裤	l 壳
王 昂	 
王 杯	 M
王 漫	 憨
王 佩	 ㄘ
王 树	 攫
王 万	 U
网 并	呼 }
往 出	┕ X
往 家	┕ a
望 并	辨 }
望 采	辨 蹦
望 出	辨 X
威逼 潘	鹿G 硷
威逼 我	鹿G и
威 格	 
韦 布	 ガ
韦 格	 
韦 家	 a
韦 托	 Λ
违背 的	HI 
违背 两	HI ㄢ
违背 了	HI F
违背 四	HI |
违背 以	HI H
违背 这	HI o
违法乱纪 的	Hk睹 
违法乱纪 及	Hk睹 の
违法 必	Hk ゲ
违法 不	Hk ぃ
违法 的	Hk 
违法 等	Hk 单
违法 和	Hk M
违法 建	Hk 
违法 添	Hk K
违法 违	Hk H
违法 占	Hk 
违法 者	Hk 
违反 八	Hは K
违反 本	Hは セ
违反 朝	Hは 绰
违反 店	Hは ┍
违反 多	Hは h
违反 关	Hは 闽
违反 国	Hは 瓣
违反 就	Hは N
违反 了	Hは F
违反 四	Hは |
违反 专	Hは M
违反 最	Hは 程
违犯 禁	Hデ T
违犯 了	Hデ F
围墙 逼	瞅鲤 G
围 并	瞅 }
围 出	瞅 X
围 堤	瞅 出
为非作歹 的	矮D@わ 
为了 出	挨F X
为了 发	挨F o
为了 丰	挨F 伦
为首 发	碍 o
为数 万	凹 U
为止 共	挨 @
为 并	 }
为 布	 ガ
为 铲	 藐
为 出	 X
为 发	 o
为 匪	 
为 丰	 伦
为 扶	 н
为 家	 a
为 坚	 绊
为 恼	 o
为 签	 帽
为 秋	 
为 苏	 默
为 万	 U
维修 布	蝴 ガ
维 采	蝴 蹦
维 澄	蝴 坚
维 苏	蝴 默
维 托	蝴 Λ
委内瑞拉 共	eず风┰ @
委派 出	e X
委员会 共	e| @
委员会 签	e| 帽
委员会 苏	e| 默
委员 布	e ガ
委员 发	e o
委员 共	e @
委员 苏	e 默
委员 万	e U
委 串	e 
委 扶	e н
委 共	e @
委 签	e 帽
委 树	e 攫
委 苏	e 默
委 托	e Λ
伟 出	岸 X
伟 丰	岸 伦
伟 伦	岸 
伪造单据 共	鞍y虫沮 @
未婚夫 商	ゼBひ 坝
未能 出	ゼ X
未 卜	ゼ R
未 出	ゼ X
未 发	ゼ o
味 秋	 
魏 格	Q 
魏 家	Q a
位 采	 蹦
位 家	 a
位 术	 N
慰问 并	饥拜 }
卫生 杯	矫ネ M
温 逼	放 G
温 布	放 ガ
温 家	放 a
文化 并	ゅて }
文件 并	ゅン }
文件 共	ゅン @
文物 共	ゅ @
文艺 家	ゅ美 a
文章 擦	ゅ彻 揽
文章 从	ゅ彻 q
文章 的	ゅ彻 
文章 都	ゅ彻 常
文章 而	ゅ彻 τ
文章 更	ゅ彻 
文章 好	ゅ彻 n
文章 和	ゅ彻 M
文章 还	ゅ彻 临
文章 获	ゅ彻 莉
文章 接	ゅ彻 钡
文章 可	ゅ彻 i
文章 里	ゅ彻 
文章 是	ゅ彻 O
文章 说	ゅ彻 弧
文章 他	ゅ彻 L
文章 也	ゅ彻 ]
文章 在	ゅ彻 b
文章 曾	ゅ彻 纯
文章 中	ゅ彻 い
文章 做	ゅ彻 暗
文 并	ゅ }
文 布	ゅ ガ
文 采	ゅ 蹦
文 家	ゅ a
闻 家	D a
稳定 并	铆w }
稳固 并	铆T }
问世 并	拜@ }
问题 并	拜D }
问题 出	拜D X
问题 发	拜D o
问题 共	拜D @
问题 签	拜D 帽
翁 伯	 B
翁 不	 ぃ
翁 达	 F
翁 的	 
翁 对	 癸
翁 多	 h
翁 福	 褐
翁 瓜	 ナ
翁 还	 临
翁 内	 ず
翁 源	 方
翁 振	 
翁 之	 ぇ
我们 并	и }
我们 出	и X
我们 发	и o
我们 家	и a
我们 舍	и 
我们 树	и 攫
我 并	и }
我 出	и X
我 扶	и н
我 家	и a
我 签	и 帽
我 舍	и 
我 托	и Λ
卧病 塌	庄f 厄
握手 并	搐も }
沃 格	U 
沃 舍	U 
乌 苏	Q 默
乌 托	Q Λ
乌 溪	Q 匪
屋 塌	 厄
无产阶级 斗	L玻顶 矮
无家可归 成	Laik Θ
无家可归 的	Laik 
无家可归 是	Laik O
无家可归 者	Laik 
无坚不摧 的	L绊ぃR 
无一 漫	L@ 憨
无意 出	LN X
无 迹	L 格
无 树	L 攫
梧桐树 苗	憋渚 ]
吴 家	d a
吴 坚	d 绊
吴 敬	d q
吴 树	d 攫
武力 并	ZO }
武器 并	Z竟 }
武术 的	ZN 
武术 馆	ZN ]
武术 列	ZN C
武术 培	ZN 蚌
武术 热	ZN 荐
武术 赛	ZN 辽
武术 散	ZN 床
武术 套	ZN M
武术 走	ZN ǐ
武 并	Z }
武 漫	Z 憨
五光十色 的	きQ 
五十 家	きQ a
五颜六色 的	きCせ 
五颜六色 羽	きCせ π
五 家	き a
舞蹈家 刀	R列a M
舞蹈家 金	R列a 
舞蹈家 刘	R列a B
伍 家	ヮ a
伍 默	ヮ q
物产 丰	玻 伦
物理学家 彼	z厩a ┘
物理学家 威	z厩a 
物理学家 严	z厩a Y
物品 丰	~ 伦
物品 托	~ Λ
物质 并	借 }
物资 串	戈 
物 出	 X
物 丰	 伦
务 并	叭 }
悟 出	 X
昔日 万	酩 U
西班牙 共	璇Z @
西部 布	璩 ガ
西部 万	璩 U
西藏 阿	杪 
西藏 把	杪 р
西藏 百	杪 κ
西藏 班	杪 Z
西藏 办	杪 快
西藏 被	杪 Q
西藏 藏	杪 旅
西藏 从	杪 q
西藏 大	杪 j
西藏 党	杪 囊
西藏 到	杪 
西藏 的	杪 
西藏 等	杪 单
西藏 地	杪 a
西藏 都	杪 常
西藏 对	杪 癸
西藏 分	杪 だ
西藏 佛	杪 
西藏 搞	杪 d
西藏 各	杪 U
西藏 更	杪 
西藏 功	杪 \
西藏 古	杪 j
西藏 和	杪 M
西藏 还	杪 临
西藏 获	杪 莉
西藏 及	杪 の
西藏 将	杪 N
西藏 教	杪 毙
西藏 境	杪 挂
西藏 距	杪 Z
西藏 旅	杪 
西藏 牧	杪 
西藏 那	杪 ê
西藏 聂	杪 驴
西藏 农	杪 A
西藏 曲	杪 Ρ
西藏 全	杪 
西藏 却	杪 o
西藏 人	杪 H
西藏 任	杪 ヴ
西藏 日	杪 ら
西藏 萨	杪 履
西藏 三	杪 T
西藏 山	杪 s
西藏 神	杪 
西藏 时	杪 
西藏 是	杪 O
西藏 所	杪 ┮
西藏 体	杪 砰
西藏 厅	杪 U
西藏 土	杪 g
西藏 吐	杪 R
西藏 文	杪 ゅ
西藏 五	杪 き
西藏 陷	杪 炒
西藏 要	杪 n
西藏 医	杪 洛
西藏 已	杪 w
西藏 有	杪 Τ
西藏 又	杪 S
西藏 与	杪 P
西藏 约	杪 
西藏 在	杪 b
西藏 扎	杪 蚕
西藏 这	杪 o
西藏 政	杪 F
西藏 制	杪 
西藏 中	杪 い
西藏 驻	杪 n
西藏 自	杪 
西藏 总	杪 `
西藏 走	杪 ǐ
西藏 最	杪 程
西藏 做	杪 暗
西德 格	杓w 
西南 布	璜n ガ
西欧国家 的	杓诎戤a 
西欧国家 及	杓诎戤a の
西欧国家 仍	杓诎戤a ご
西欧国家 已	杓诎戤a w
西欧国家 在	杓诎戤a b
西欧国家 中	杓诎戤a い
西医 的	杪 
西医 间	杪 丁
西医 无	杪 L
西 出	 X
西 发	 o
西 丰	 伦
西 格	 
西 家	 a
西 苏	 默
西 托	 Λ
西 翁	 
吸出 心	lX み
稀 树	} 攫
希望 并	票 }
希望 发	票 o
希望 苏	票 默
希 格	 
烯烃 共	mL @
溪 城	匪 
溪 冲	匪 R
溪 到	匪 
溪 等	匪 单
溪 河	匪 e
溪 湖	匪 打
溪 江	匪 
溪 卷	匪 
溪 区	匪 跋
溪 泉	匪 u
溪 市	匪 カ
溪 水	匪 
溪 尾	匪 Ю
溪 卫	匪 矫
溪 五	匪 き
溪 县	匪 郡
溪 乡	匪 m
溪 也	匪 ]
溪 峪	匪 n
溪 站	匪 
溪 镇	匪 马
溪 溥	匪 妨
媳 背	@ I
喜出望外 了	尺X辨~ F
洗衣 裤	~ 壳
洗 发	~ o
系列 共	tC @
系统 布	t参 ガ
系统 采	t参 蹦
系统 共	t参 @
系 并	t }
系 万	t U
细管 颈	灿恨 V
下车 铲	Uó 藐
下降 并	U }
下来 并	Uㄓ }
下午 共	Uと @
下旬 出	UΟ X
下 采	U 蹦
下 出	U X
下 发	U o
下 签	U 帽
下 树	U 攫
下 塌	U 厄
下 箸	U 烘
厦门 万	H U
夏 家	L a
夏 秋	L 
先锋 杯	W M
先后 出	 X
先后 发	 o
先后 共	 @
先后 树	 攫
先进国家 的	i瓣a 
先进 树	i 攫
先生 并	ネ }
先 发	 o
先 家	 a
鲜 共	A @
鲜 签	A 帽
弦歌 声	┒q n
弦 的	┒ 
弦 之	┒ ぇ
显出 雷	陪X p
显出 耐	陪X @
显出 为	陪X 
显出 一	陪X @
显达 家	陪F a
显露 出	陪S X
显示 板	陪ボ O
显示 出	陪ボ X
显现 出	陪{ X
显著 丰	陪帝 伦
显著 疗	陪帝 励
险 并	I }
现出来 的	{Xㄓ 
现出 百	{X κ
现出 不	{X ぃ
现出 大	{X j
现出 的	{X 
现出 各	{X U
现出 更	{X 
现出 了	{X F
现出 露	{X S
现出 欧	{X 稼
现出 其	{X ㄤ
现出 人	{X H
现出 上	{X W
现出 舍	{X 
现出 数	{X 计
现出 腾	{X 乃
现出 我	{X и
现出 许	{X \
现出 一	{X @
现出 张	{X i
现阶段 阿	{顶q 
现阶段 的	{顶q 
现阶段 两	{顶q ㄢ
现阶段 我	{顶q и
现实 并	{龟 }
现象 并	{H }
现在 共	{b @
现在 家	{b a
现 共	{ @
献给 苏	m倒 默
献 出	m X
县分 布	郡だ ガ
县 布	郡 ガ
县 出	郡 X
县 扶	郡 н
县 共	郡 @
县 签	郡 帽
县 秋	郡 
县 万	郡 U
羡慕 邢	r} ǚ
宪法草案 是	舅k螽 O
宪法 并	舅k }
宪法 共	舅k @
陷害 等	炒` 单
限额 不	B ぃ
限额 持	B 
限额 的	B 
限额 多	B h
限额 和	B M
限额 及	B の
限额 将	B N
限额 降	B 
限额 上	B W
限额 是	B O
限额 为	B 
限量 采	q 蹦
线索 共	u @
线 并	u }
线 出	u X
线 共	u @
线 婉	u 胞
相比 并	郅 }
相比 布	郅 ガ
相互 扶	郅 н
相继 发	勰~ o
相信 苏	郢H 默
相 背	 I
相 扶	 н
香港 万	淮 U
香 并	 }
香 格	 
香 树	 攫
香 溪	 匪
湘 家	答 a
乡土气息 的	mg甬 
乡镇 敬	m马 q
乡 出	m X
乡 串	m 
乡 共	m @
乡 敬	m q
乡 邢	m ǚ
祥 斗	不 矮
祥 家	不 a
想出 不	QX ぃ
想出 来	QX ㄓ
想出 了	QX F
想到 家	Q a
想到 敬	Q q
想家 的	Qa 
想像 出	Q钩 X
项目 布	兜ヘ ガ
项目 共	兜ヘ @
项目 签	兜ヘ 帽
项 杯	兜 M
项 丰	兜 伦
项 扶	兜 н
项 共	兜 @
项 签	兜 帽
项 苏	兜 默
橡胶树 为	倔溅攫 
向下 出	VU X
向 布	V ガ
向 发	V o
向 丰	V 伦
向 坚	V 绊
向 敬	V q
向 佩	V ㄘ
向 苏	V 默
向 万	V U
象 发	H o
象 扶	H н
象 格	H 
销声匿迹 了	Pn拔格 F
销售总额 比	P扳`B ゑ
销售总额 达	P扳`B F
销售总额 的	P扳`B 
销售总额 高	P扳`B 蔼
销售总额 为	P扳`B 
销售 出	P扳 X
销售 额	P扳 B
销 出	P X
销 额	P B
消除 苏	埃 默
消费者 发	O o
消费 并	O }
消费 额	O B
晓 佩	惧 ㄘ
小麦 并	p沉 }
小麦 丰	p沉 伦
小卫星 共	p矫P @
小溪 坝	p匪 膨
小溪 和	p匪 M
小组 出	p舱 X
小组 共	p舱 @
小组 苏	p舱 默
小 额	p B
小 发	p o
小 家	p a
小 敬	p q
小 树	p 攫
孝敬 她	Уq o
孝敬 王	Уq 
校舍 八	摘 K
校舍 的	摘 
校舍 等	摘 单
校舍 和	摘 M
校舍 很	摘 
校舍 危	摘 M
校舍 一	摘 @
校舍 占	摘 
校舍 中	摘 い
校舍 总	摘 `
校 共	 @
肖 树	v 攫
效果 并	莫G }
歇脚 树	凡} 攫
鞋匠 教	cK 毙
鞋匠 听	cK 钮
鞋匠 修	cK 
鞋 帽	c U
鞋 万	c U
协定 并	螬w }
协会 共	蠓| @
协议草案 的	竽朝螽 
协议草案 和	竽朝螽 M
协议书 签	竽钞 帽
协议 并	竽 }
协议 签	竽 帽
协 杯	 M
协 扶	 н
协 共	 @
携带 签	拟a 帽
写文章 同	gゅ彻 P
写 出	g X
卸下 并	U }
泄 出	n X
泻出 来	mX ㄓ
谢 万	谅 U
锌 并	N }
辛 格	ǒ 
新产品 并	s玻~ }
新产品 出	s玻~ X
新潮 发	s奸 o
新婚 后	sB 
新婚 家	sB a
新婚 时	sB 
新婚 燕	sB P
新加坡 签	s[Y 帽
新疆 共	s忙 @
新闻公报 称	sDそ厨 嘿
新闻公报 对	sDそ厨 癸
新闻公报 说	sDそ厨 弧
新闻公报 中	sDそ厨 い
新星 杯	sP M
新 背	s I
新 并	s }
新 布	s ガ
新 采	s 蹦
新 发	s o
新 丰	s 伦
新 裤	s 壳
新 帽	s U
新 签	s 帽
新 树	s 攫
心地 扑	みa 汲
心脏病 并	み纽f }
心脏移植 到	み纽簿从 
心脏移植 的	み纽簿从 
心脏移植 主	み纽簿从 D
心 斗	み 矮
心 扑	み 汲
心 树	み 攫
信口开河 漫	Hf}e 憨
信用保险 等	HノOI 单
信 并	H }
信 发	H o
信 托	H Λ
星光 杯	P M
星罗棋布 的	P霉囱ガ 
星罗棋布 在	P霉囱ガ b
兴办 扶	砍快 н
兴建 扶	砍 н
兴起 并	砍_ }
兴 杯	砍 M
兴 并	砍 }
兴 格	砍 
刑事罪 和	Dㄆo M
刑事 发	Dㄆ o
型 并	 }
形式 并	桅 }
形态 的	魏A 
形态 等	魏A 单
形态 范	魏A S
形态 各	魏A U
形态 和	魏A M
形态 上	魏A W
形态 图	魏A 瓜
邢 崇	ǚ R
邢 春	ǚ K
邢 村	ǚ 
邢 德	ǚ w
邢 芬	ǚ 
邢 耿	ǚ 
邢 贵	ǚ Q
邢 丽	ǚ R
邢 台	ǚ x
邢 雁	ǚ 董
邢 诒	ǚ 圻
行程 万	娴{ U
行动 并	姘 }
行家 大	娈a j
行家 们	娈a 
行家 说	娈a 弧
行家 谈	娈a 酵
行李 家	妲 a
行为 背	娆 I
行销 到	婢P 
行业 出	娣~ X
行业 树	娣~ 攫
行 共	 @
行 迹	 格
行 漫	 憨
行 树	 攫
行 万	 U
杏 出	 X
杏 树	 攫
性格演员 佩	┦婧t ㄘ
性格 跨	┦ 阁
性格 也	┦ ]
性能测试 和	┦啻刚 M
性 并	┦ }
性 发	┦ o
性 坚	┦ 绊
凶暴 的	た忌 
匈 签	I 帽
匈 苏	I 默
休戚与共 的	ヰ杯P@ 
修理 家	撞z a
修 发	 o
修 家	 a
秀 发	q o
秀 家	q a
秀 邢	q ǚ
需要 发	惠n o
虚 发	店 o
徐 采	} 蹦
徐 发	} o
徐 家	} a
许多 丰	\h 伦
许多 共	\h @
许多 家	\h a
许 家	\ a
叙 伦	痹 
畜牧 扶	b н
畜 舍	b 
续 签	尿 帽
宣布独立 的	钮Wミ 
宣布独立 日	钮Wミ ら
宣布独立 之	钮Wミ ぇ
宣布 阿	钮 
宣布 埃	钮 J
宣布 安	钮 w
宣布 巴	钮 ぺ
宣布 北	钮 _
宣布 成	钮 Θ
宣布 处	钮 B
宣布 从	钮 q
宣布 大	钮 j
宣布 党	钮 囊
宣布 倒	钮 
宣布 的	钮 
宣布 第	钮 材
宣布 对	钮 癸
宣布 多	钮 h
宣布 该	钮 赣
宣布 戈	钮 む
宣布 和	钮 M
宣布 合	钮 X
宣布 后	钮 
宣布 将	钮 N
宣布 就	钮 N
宣布 举	钮 |
宣布 军	钮 x
宣布 科	钮 
宣布 两	钮 ㄢ
宣布 了	钮 F
宣布 纳	钮 
宣布 南	钮 n
宣布 其	钮 ㄤ
宣布 使	钮 ㄏ
宣布 说	钮 弧
宣布 它	钮 ウ
宣布 同	钮 P
宣布 推	钮 崩
宣布 吞	钮 ]
宣布 为	钮 
宣布 我	钮 и
宣布 下	钮 U
宣布 向	钮 V
宣布 新	钮 s
宣布 要	钮 n
宣布 一	钮 @
宣布 已	钮 w
宣布 意	钮 N
宣布 有	钮 Τ
宣布 与	钮 P
宣布 原	钮 
宣布 愿	钮 @
宣布 在	钮 b
宣布 这	钮 o
宣布 自	钮 
宣布 组	钮 舱
宣传 板	哦 O
宣传 疗	哦 励
宣 佩	 ㄘ
悬殊 的	a 
选拔 出	匡┺ X
选出 百	匡X κ
选出 的	匡X 
选出 该	匡X 赣
选出 来	匡X ㄓ
选出 梁	匡X 辩
选出 两	匡X ㄢ
选出 了	匡X F
选出 名	匡X W
选出 三	匡X T
选出 特	匡X S
选出 万	匡X U
选出 新	匡X s
选出 一	匡X @
选出 优	匡X u
选举 并	匡| }
选举 出	匡| X
选举 共	匡| @
选举 万	匡| U
选派 出	匡 X
选手 并	匡も }
选手 布	匡も ガ
选手 丰	匡も 伦
选手 格	匡も 
选手 共	匡も @
选手 伦	匡も 
选手 佩	匡も ㄘ
选手 苏	匡も 默
选手 涂	匡も 额
选手 托	匡も Λ
选手 珀	匡も 
选育 出	匡| X
选择 并	匡拒 }
选 共	匡 @
选 家	匡 a
学人 家	厩H a
学生 背	厩ネ I
学生 出	厩ネ X
学生 共	厩ネ @
学生 扑	厩ネ 汲
学生 苏	厩ネ 默
学生 托	厩ネ Λ
学术交流 的	厩Nユy 
学术交流 等	厩Nユy 单
学术交流 和	厩Nユy M
学术交流 上	厩Nユy W
学术交流 为	厩Nユy 
学术界 的	厩N 
学术界 一	厩N @
学术界 有	厩N Τ
学术论文 和	厩N阶ゅ M
学术论文 为	厩N阶ゅ 
学术论文 也	厩N阶ゅ ]
学术 成	厩N Θ
学术 和	厩N M
学术 前	厩N e
学术 上	厩N W
学术 新	厩N s
学术 型	厩N 
学术 性	厩N ┦
学术 专	厩N M
学习 并	厩策 }
学校 共	厩 @
学员 布	厩 ガ
学院 发	厩| o
学者 共	厩 @
学者 苏	厩 默
学 共	厩 @
学 家	厩 a
雪 杯	撤 M
雪 并	撤 }
雪 雕	撤 J
雪 斗	撤 矮
血管 丰	搴 伦
血迹 的	甯 
血迹 较	甯 耕
血压 并	謇 }
熏 得	饫 o
熏 黑	饫 堵
熏 昏	饫 
熏 火	饫 
熏 染	饫 V
熏 陶	饫 吵
熏 吸	饫 l
熏 心	饫 み
熏 鱼	饫 辰
熏 蒸	饫 ]
寻求 并	MD }
寻求 丰	MD 伦
寻找 出	Mт X
训 出	V X
训 敬	V q
训 秋	V 
迅速 并	ǔt }
亚运会 并	ㄈB| }
亚运会 出	ㄈB| X
亚运会 丰	ㄈB| 伦
亚运会 共	ㄈB| @
亚运 杯	ㄈB M
亚洲开发银行 的	ㄈw}o蝗 
亚洲开发银行 共	ㄈw}o蝗 @
亚洲开发银行 和	ㄈw}o蝗 M
亚洲开发银行 京	ㄈw}o蝗 ㄊ
亚洲开发银行 行	ㄈw}o蝗 
亚洲 杯	ㄈw M
亚 并	ㄈ }
亚 布	ㄈ ガ
亚 共	ㄈ @
烟 斗	废 矮
烟 熏	废 饫
盐田 的	Qバ 
盐田 港	Qバ 翠
严格 按	Y 
严格 把	Y р
严格 查	Y d
严格 党	Y 囊
严格 的	Y 
严格 地	Y a
严格 各	Y U
严格 火	Y 
严格 检	Y 浪
严格 评	Y 蝶
严格 审	Y f
严格 所	Y ┮
严格 细	Y 灿
严格 依	Y ㄌ
严格 抓	Y ъ
严 家	Y a
研究出 的	悒sX 
研究出 多	悒sX h
研究出 粉	悒sX 
研究出 了	悒sX F
研究出 一	悒sX @
研究所 格	悒s┮ 
研究 并	悒s }
研究 共	悒s @
研 共	 @
言 出	ē X
阎 树	F 攫
炎 发	 o
沿街 漫	u刁 憨
眼圈 发	泊伴 o
眼下 并	泊U }
眼 漫	泊 憨
演唱 家	t佰 a
演出 报	tX 厨
演出 的	tX 
演出 等	tX 单
演出 队	tX 钉
演出 发	tX o
演出 归	tX k
演出 和	tX M
演出 很	tX 
演出 后	tX 
演出 及	tX の
演出 奖	tX 贱
演出 剧	tX @
演出 矿	tX q
演出 两	tX ㄢ
演出 了	tX F
演出 前	tX e
演出 深	tX `
演出 时	tX 
演出 受	tX 
演出 体	tX 砰
演出 田	tX バ
演出 团	tX 刮
演出 推	tX 崩
演出 为	tX 
演出 五	tX き
演出 呀	tX r
演出 一	tX @
演出 有	tX Τ
演出 之	tX ぇ
演出 中	tX い
演出 荟	tX P
演讲 并	t量 }
演说家 们	t弧a 
演员 格	t 
演奏家 陈	t诞a 朝
演奏家 娜	t诞a R
演奏家 玉	t诞a ド
演奏家 约	t诞a 
燕 杯	P M
燕 发	P o
秧苗 等	杯] 单
秧苗 卷	杯] 
杨柳树 栽	法h攫 
杨 发	法 o
杨 家	法 a
杨 坚	法 绊
杨 树	法 攫
扬 斗	喘 矮
扬 树	喘 攫
扬 托	喘 Λ
羊肉 串	οψ 
羊 出	ο X
洋 万	v U
仰泳 共	ヵa @
养鱼场 和	i辰初 M
养 出	i X
样品 并	妓~ }
样 板	妓 O
样 丰	妓 伦
邀请 万	淋叫 U
腰 板	y O
瑶 家	航 a
遥 万	换 U
药理学 术	媚z厩 N
药品 并	媚~ }
药物治疗 到	媚v励 
药物治疗 时	媚v励 
药 杯	媚 M
药 并	媚 }
药 疗	媚 励
要求 布	nD ガ
要求 出	nD X
要求 发	nD o
要求 格	nD 
要求 苏	nD 默
要人 扶	nH н
要事 迹	nㄆ 格
要 逼	n G
要 出	n X
要 发	n o
要 丰	n 伦
要 舍	n 
要 塌	n 厄
耶 出	C X
爷 采	份 蹦
爷 家	份 a
野 婚	偿 B
也 背	] I
也 并	] }
也 出	] X
也 发	] o
也 签	] 帽
业 杯	~ M
业 布	~ ガ
业 家	~ a
业 托	~ Λ
叶 佩	腑 ㄘ
叶 树	腑 攫
夜 出	] X
一般 发	@ o
一点 家	@I a
一定 额	@w B
一定 疗	@w 励
一二 斗	@G 矮
一番 家	@f a
一方面 发	@よ o
一共 打	@@ ゴ
一共 奖	@@ 贱
一共 破	@@ }
一共 提	@@ 矗
一共 需	@@ 惠
一家人 的	@aH 
一家人 都	@aH 常
一家人 呵	@aH 
一家人 临	@aH {
一家人 围	@aH 瞅
一家人 在	@aH b
一家人 怎	@aH 
一家之主 的	@aぇD 
一家子 都	@al 常
一连串 的	@s 
一连串 空	@s 
一连串 受	@s 
一切 并	@ち }
一天 共	@ぱ @
一同 出	@P X
一下子 把	@Ul р
一下子 成	@Ul Θ
一下子 打	@Ul ゴ
一下子 减	@Ul 搭
一下子 解	@Ul 秆
一下子 就	@Ul N
一下子 买	@Ul R
一下子 全	@Ul 
一下子 散	@Ul 床
一下子 瘫	@Ul 捧
一下子 躺	@Ul 仅
一下子 由	@Ul パ
一下子 又	@Ul S
一下子 挣	@Ul 泵
一下子 赚	@Ul 寥
一线 并	@u }
一小撮 人	@p技 H
一些 树	@ㄇ 攫
一心一意 扑	@み@N 汲
一氧化碳 熏	@瘠坪 饫
一一 婉	@@ 胞
一 杯	@ M
一 并	@ }
一 铲	@ 藐
一 出	@ X
一 串	@ 
一 撮	@ 技
一 发	@ o
一 丰	@ 伦
一 家	@ a
一 疗	@ 励
一 签	@ 帽
医疗保健 的	洛励O胺 
医疗保健 和	洛励O胺 M
医疗保健 气	洛励O胺 
医疗保险 金	洛励OI 
医疗费用 和	洛励Oノ M
医疗费用 中	洛励Oノ い
医疗设备 和	洛励]称 M
医疗系统 开	洛励t参 }
医疗用品 都	洛励ノ~ 常
医疗用品 类	洛励ノ~ 摸
医疗用品 是	洛励ノ~ O
医疗 城	洛励 
医疗 等	洛励 单
医疗 点	洛励 I
医疗 队	洛励 钉
医疗 费	洛励 O
医疗 和	洛励 M
医疗 护	洛励 @
医疗 奇	洛励 _
医疗 器	洛励 竟
医疗 上	洛励 W
医疗 室	洛励 
医疗 箱	洛励 c
医疗 小	洛励 p
医疗 新	洛励 s
医疗 业	洛励 ~
医疗 站	洛励 
医疗 组	洛励 舱
医术 高	洛N 蔼
医术 和	洛N M
医术 是	洛N O
医术 在	洛N b
医学 并	洛厩 }
医学 家	洛厩 a
医药 杯	洛媚 M
医院 并	洛| }
医院 发	洛| o
医院 共	洛| @
依托 鞍	ㄌΛ b
依托 产	ㄌΛ 玻
依托 的	ㄌΛ 
依托 而	ㄌΛ τ
依托 和	ㄌΛ M
依托 陆	ㄌΛ 嘲
依 采	ㄌ 蹦
伊拉克 苏	レ┰J 默
伊 布	レ ガ
伊 格	レ 
伊 伦	レ 
伊 万	レ U
衣服 扑	绐A 汲
衣 裤	 壳
遗传 共	框肚 @
遗迹 的	框格 
遗迹 如	框格 p
遗迹 时	框格 
遗像 敬	框钩 q
移植 到	簿从 
移植 的	簿从 
移植 给	簿从 倒
移植 后	簿从 
移植 可	簿从 i
移植 了	簿从 F
移植 卵	簿从 Z
移植 术	簿从 N
移植 所	簿从 ┮
移植 同	簿从 P
移植 兔	簿从 ㄟ
移植 物	簿从 
移植 小	簿从 p
移植 协	簿从 
移植 一	簿从 @
移植 与	簿从 P
移植 猪	簿从 睫
仪式 并	祸Α }
疑虑 并	好{ }
沂 溪	^ 匪
彝 家	U a
已出版 的	wX 
已出版 和	wX M
已出版 了	wX F
已出版 专	wX M
已婚 育	wB |
已经 背	wg I
已经 并	wg }
已经 出	wg X
已经 签	wg 帽
已开发 出	w}o X
已开发 的	w}o 
已开发 省	w}o 
已 并	w }
已 卜	w R
已 采	w 蹦
已 出	w X
已 发	w o
已 扑	w 汲
已 签	w 帽
以及 并	Hの }
以及 苏	Hの 默
以来 采	Hㄓ 蹦
以来 共	Hㄓ @
以前 发	He o
以前 签	He 帽
以色列 签	H猞C 帽
以上 家	HW a
以下 扑	HU 汲
以 出	H X
以 发	H o
以 丰	H 伦
以 扶	H н
以 伦	H 
以 签	H 帽
以 秋	H 
以 苏	H 默
以 万	H U
艺术家 程	美Na {
艺术家 戴	美Na 拦
艺术家 的	美Na 
艺术家 关	美Na 闽
艺术家 和	美Na M
艺术家 黄	美Na 独
艺术家 及	美Na の
艺术家 李	美Na 
艺术家 们	美Na 
艺术家 裴	美Na p
艺术家 荣	美Na a
艺术家 身	美Na ō
艺术家 沈	美Na H
艺术家 是	美Na O
艺术家 唐	美Na 
艺术家 通	美Na q
艺术家 肖	美Na v
艺术家 要	美Na n
艺术家 一	美Na @
艺术家 以	美Na H
艺术家 有	美Na Τ
艺术家 与	美Na P
艺术家 在	美Na b
艺术家 之	美Na ぇ
艺术家 臧	美Na N
艺术节 的	美N` 
艺术节 上	美N` W
艺术节 以	美N` H
艺术节 之	美N` ぇ
艺术品 被	美N~ Q
艺术品 的	美N~ 
艺术品 和	美N~ M
艺术品 能	美N~ 
艺术品 在	美N~ b
艺术品 中	美N~ い
艺术院 师	美N| v
艺术院 校	美N| 
艺术作品 向	美N@~ V
艺术 爱	美N R
艺术 部	美N 场
艺术 成	美N Θ
艺术 得	美N o
艺术 的	美N 
艺术 灯	美N O
艺术 等	美N 单
艺术 地	美N a
艺术 对	美N 癸
艺术 宫	美N c
艺术 和	美N M
艺术 化	美N て
艺术 积	美N n
艺术 及	美N の
艺术 界	美N 
艺术 精	美N 弘
艺术 景	美N 春
艺术 局	美N Ы
艺术 剧	美N @
艺术 美	美N 
艺术 门	美N 
艺术 明	美N 
艺术 片	美N 
艺术 热	美N 荐
艺术 三	美N T
艺术 上	美N W
艺术 摄	美N 尼
艺术 水	美N 
艺术 硕	美N 河
艺术 司	美N q
艺术 所	美N ┮
艺术 陶	美N 吵
艺术 厅	美N U
艺术 同	美N P
艺术 团	美N 刮
艺术 为	美N 
艺术 无	美N L
艺术 系	美N t
艺术 性	美N ┦
艺术 也	美N ]
艺术 已	美N w
艺术 以	美N H
艺术 饮	美N 都
艺术 影	美N v
艺术 有	美N Τ
艺术 与	美N P
艺术 在	美N b
艺术 展	美N i
艺术 绽	美N 红
艺术 争	美N 
艺术 之	美N ぇ
艺术 直	美N 
艺术 中	美N い
艺术 总	美N `
艺术 做	美N 暗
艺术 荟	美N P
艺 家	美 a
易货贸易 额	龀fT B
易 卜	 R
易 发	 o
亿万 人	货U H
亿万 职	货U 戮
意大利 出	NjQ X
意大利 托	NjQ Λ
意见 并	Nǎ }
意气风发 地	N瓠返o a
意识到 车	N醚 ó
意识到 党	N醚 囊
意识到 你	N醚 A
意识到 它	N醚 ウ
意识到 效	N醚 
意识到 这	N醚 o
意识 摆	N醚 \
意识 被	N醚 Q
意识 不	N醚 ぃ
意识 差	N醚 t
意识 大	N醚 j
意识 的	N醚 
意识 搞	N醚 d
意识 和	N醚 M
意识 就	N醚 N
意识 强	N醚 j
意识 使	N醚 ㄏ
意识 是	N醚 O
意识 为	N醚 
意识 也	N醚 ]
意识 已	N醚 w
意识 在	N醚 b
意 共	N @
毅然 舍	驾M 
毅 杯	驾 M
义务 扑	q叭 汲
义演 是	qt O
义演 中	qt い
义 布	q ガ
义 翁	q 
益 并	q }
议长 苏	某 默
议会 发	某| o
议会 共	某| @
译 并	亩 }
译 出	亩 X
荫 敬	疆 q
因事外出 了	]ㄆ~X F
因 出	] X
因 家	] a
音乐家 的	导之a 
音乐家 们	导之a 
音乐家 是	导之a O
音乐家 冼	导之a 宋
阴谋 家	潮垦 a
阴 并	潮 }
银行 并	蝗 }
银行 发	蝗 o
银行 扶	蝗 н
银行 共	蝗 @
银行 签	蝗 帽
银行 万	蝗 U
银 发	蝗 o
银 妆	蝗 З
饮料 并	都 }
引出 了	まX F
引出 千	まX d
引发 出	まo X
引发 的	まo 
引发 高	まo 蔼
引发 了	まo F
引发 源	まo 方
引 堤	ま 出
印出 来	LX ㄓ
印度洋 出	L赚v X
印度 板	L O
印发 各	Lo U
印发 过	Lo L
印发 科	Lo 
印发 了	Lo F
印染 布	LV ガ
印 共	L @
印 迹	L 格
印 签	L 帽
英格兰 的	^婺 
英格兰 队	^婺 钉
英格兰 高	^婺 蔼
英格兰 和	^婺 M
英格兰 获	^婺 莉
英格兰 老	^婺 ρ
英国 并	^瓣 }
英国 格	^瓣 
英国 共	^瓣 @
英军 并	^x }
英 出	^ X
英 发	^ o
英 家	^ a
英 伦	^ 
英 树	^ 攫
英 苏	^ 默
应用 并	莱ノ }
应 出	莱 X
应 发	莱 o
应 汲	莱 V
应 签	莱 帽
应 苏	莱 默
营救 出	犁毕 X
营养学家 西	犁i厩a 
营养 丰	犁i 伦
营业 额	犁~ B
营 共	犁 @
赢得 采	墓o 蹦
盈利 额	乍Q B
影响 并	vT }
映出 的	MX 
映出 时	MX 
映出 张	MX i
映出 总	MX `
拥护 并	局@ }
拥有 丰	局Τ 伦
踊跃 地	裤D a
踊跃 发	裤D o
涌 出	F X
涌 家	F a
永久性 并	ッ[┦ }
永 发	ッ o
永 格	ッ 
永 万	ッ U
勇 斗	i 矮
勇 舍	i 
勇 托	i Λ
用户 家	ノめ a
用 矮	ノ G
用 丰	ノ 伦
用 树	ノ 攫
用 万	ノ U
幽默 成	绽q Θ
幽默 等	绽q 单
幽默 地	绽q a
幽默 调	绽q 秸
优良 树	u} 攫
优势 并	u墩 }
优异 成	u钵 Θ
优异 的	u钵 
优异 奖	u钵 贱
优异 战	u钵 驹
优异 者	u钵 
忧 并	~ }
尤 杯	ぷ M
尤 溪	ぷ 匪
由 布	パ ガ
由 丰	パ 伦
由 格	パ 
由 苏	パ 默
由 万	パ U
邮票 共	l布 @
油井 采	oか 蹦
油田 并	oバ }
油 并	o }
油 树	o 攫
游 出	村 X
有板有眼 地	ΤOΤ泊 a
有关部门 共	Τ闽场 @
有关 苏	Τ闽 默
有目共睹 的	Τヘ@@ 
有人 出	ΤH X
有时 并	Τ }
有数 万	Τ计 U
有希望 成	Τ票 Θ
有希望 的	Τ票 
有希望 夺	Τ票 管
有希望 了	Τ票 F
有希望 吗	Τ票 盾
有希望 拿	Τ票 
有喜 有	Τ尺 Τ
有系统 性	Τt参 ┦
有限公司 承	Τそq ┯
有限公司 船	Τそq 差
有限公司 的	Τそq 
有限公司 等	Τそq 单
有限公司 和	Τそq M
有限公司 建	Τそq 
有限公司 将	Τそq N
有限公司 近	Τそq 
有限公司 两	Τそq ㄢ
有限公司 签	Τそq 帽
有限公司 是	Τそq O
有限公司 四	Τそq |
有限公司 所	Τそq ┮
有限公司 为	Τそq 
有限公司 向	Τそq V
有限公司 研	Τそq 
有限公司 杨	Τそq 法
有限公司 已	Τそq w
有限公司 与	Τそq P
有限公司 在	Τそq b
有限公司 赞	Τそq g
有限公司 只	Τそq u
有限公司 主	Τそq D
有限 的	Τ 
有限 度	Τ 
有限 期	Τ 戳
有限 元	Τ じ
有限 之	Τ ぇ
有线电视 台	Τuq跌 x
有线电视 网	Τuq跌 呼
有线广播 网	Τus冀 呼
有线广播 站	Τus冀 
有些 并	Τㄇ }
有意识 地	ΤN醚 a
有资格 成	Τ戈 Θ
有资格 对	Τ戈 癸
有资格 面	Τ戈 
有资格 说	Τ戈 弧
有 布	Τ ガ
有 采	Τ 蹦
有 出	Τ X
有 发	Τ o
有 丰	Τ 伦
有 扶	Τ н
有 共	Τ @
有 迹	Τ 格
有 坚	Τ 绊
有 敬	Τ q
有 疗	Τ 励
有 伦	Τ 
有 术	Τ N
有 树	Τ 攫
有 万	Τ U
友谊 杯	ね剿 M
友谊 发	ね剿 o
友谊 树	ね剿 攫
右 舍	k 
诱 发	护 o
又 矮	S G
又 布	S ガ
又 出	S X
又 发	S o
又 丰	S 伦
又 扶	S н
又 签	S 帽
又 舍	S 
幼发拉底河 和	ギo┰┏e M
幼发拉底河 畔	ギo┰┏e `
幼 发	ギ o
幼 树	ギ 攫
幼 婉	ギ 胞
于 矮	_ G
于 昂	_ 
于 板	_ O
于 背	_ I
于 布	_ ガ
于 采	_ 蹦
于 铲	_ 藐
于 出	_ X
于 发	_ o
于 丰	_ 伦
于 扶	_ н
于 格	_ 
于 家	_ a
于 扑	_ 汲
于 签	_ 帽
于 树	_ 攫
于 苏	_ 默
榆树 和	樊攫 M
愚 出	M X
余 并	E }
余 额	E B
余 家	E a
余 扑	E 汲
余 秋	E 
余 万	E U
鱼 共	辰 @
渔 况	寒 p
与 布	P ガ
与 斗	P 矮
与 发	P o
与 共	P @
与 苏	P 默
与 万	P U
禹 杯	 M
玉兰 树	ド孽 攫
玉米 丰	ドμ 伦
玉 雕	ド J
玉 家	ド a
玉 树	ド 攫
玉 溪	ド 匪
域 共	办 @
吁 布	S ガ
遇 并	J }
遇 迹	J 格
喻为 斗	畴 矮
喻 万	畴 U
御 并	s }
愈 出	U X
愈 发	U o
愈 坚	U 绊
欲 熏	饼 饫
育 出	| X
预报 出	w厨 X
预测 部	w代 场
预测 到	w代 
预测 的	w代 
预测 等	w代 单
预测 调	w代 秸
预测 过	w代 L
预测 和	w代 M
预测 及	w代 の
预测 时	w代 
预测 是	w代 O
预测 说	w代 弧
预测 型	w代 
预测 与	w代 P
预测 再	w代 A
预防 并	w }
预计 出	wp X
预料 布	w ガ
预赛 出	w辽 X
预算草案 中	w衡螽 い
预算 额	w衡 B
鸳鸯 溪	pm 匪
元宵 共	じd @
元 家	じ a
袁 婉	K 胞
原来 格	歙 
原料 出	飚 X
原料 丰	飚 伦
原有 扶	歃 н
原则 并	飓h }
原则 共	飓h @
原 板	 O
原 发	 o
援助 共	穿U @
园丁 杯	堕B M
园林 布	堕L ガ
园 杯	堕 M
员 并	 }
员 布	 ガ
员 出	 X
员 斗	 矮
员 发	 o
员 扶	 н
员 共	 @
员 敬	 q
源 丰	方 伦
远期 疗	环戳 励
远行 时	环 
远 杯	环 M
愿 出	@ X
院 共	| @
院 签	| 帽
约束力 并	簸O }
约 万	 U
越发 的	Vo 
越过 扑	VL 汲
越来越 丰	VㄓV 伦
越南 并	Vn }
越南 共	Vn @
越 背	V I
越 丰	V 伦
越 共	V @
越 坚	V 绊
越 签	V 帽
跃进 杯	Di M
跃 出	D X
岳父 家	┄ a
岳 家	┄ a
月出 任	るX ヴ
月底 共	る┏ @
月中 共	るい @
月 发	る o
月 签	る 帽
月 苏	る 默
悦 逼	 G
云南省 共	冻n @
云 出	冻 X
云 溪	冻 匪
运动会 共	B笆| @
运动员 背	B笆 I
运动员 布	B笆 ガ
运动员 出	B笆 X
运动员 共	B笆 @
运动员 舍	B笆 
运动员 托	B笆 Λ
运动员 邢	B笆 ǚ
运气 发	B o
运送 万	Be U
运作 出	B@ X
运 出	B X
运 丰	B 伦
杂项 制	馒兜 
杂 树	馒 攫
栽 秋	 
栽 树	 攫
再 签	A 帽
在案 板	b O
在 昂	b 
在 板	b O
在 布	b ガ
在 采	b 蹦
在 出	b X
在 堤	b 出
在 发	b o
在 丰	b 伦
在 扶	b н
在 格	b 
在 共	b @
在 焊	b k
在 汲	b V
在 家	b a
在 颈	b V
在 敬	b q
在 漫	b 憨
在 签	b 帽
在 树	b 攫
在 苏	b 默
在 托	b Λ
在 万	b U
在 溪	b 匪
在 邢	b ǚ
咱家 里	ギa 
赞扬 格	g喘 
赞扬 苏	g喘 默
赞 布	g ガ
遭受 别	D O
遭受 大	D j
遭受 到	D 
遭受 的	D 
遭受 干	D F
遭受 更	D 
遭受 过	D L
遭受 了	D F
遭受 三	D T
遭受 水	D 
遭受 雪	D 撤
遭受 一	D @
遭受 著	D 帝
遭 秋	D 
凿 出	w X
早点 出	ΝI X
早婚 早	ΝB Ν
早期 丰	Ν戳 伦
早日 出	Νら X
早 扑	Ν 汲
造成 漫	yΘ 憨
造就 出	yN X
造林 并	yL }
造林 共	yL @
造林 树	yL 攫
造纸厂 的	y燃t 
造纸厂 吨	y燃t 痉
造纸厂 和	y燃t M
造纸厂 还	y燃t 临
造纸厂 拉	y燃t ┰
造纸厂 是	y燃t O
造纸厂 位	y燃t 
造纸厂 在	y燃t b
造纸厂 造	y燃t y
造 布	y ガ
造 出	y X
造 术	y N
责任 共	dヴ @
增产 丰	W玻 伦
增长 并	W }
增加 额	W[ B
增 额	W B
增 发	W o
增 佩	W ㄘ
曾 出	纯 X
曾 敬	纯 q
曾 佩	纯 ㄘ
扎 布	蚕 ガ
轧 板	 O
轧 出	 X
炸 塌	 厄
摘 出	K X
债券 额	杜ㄩ B
债务 并	杜叭 }
债务 额	杜叭 B
寨 树	闺 攫
展开 殊	i} 
展览会 共	i凝| @
展览 共	i凝 @
展示 出	iボ X
展望 苏	i辨 默
展 并	i }
展 出	i X
展 丰	i 伦
展 扶	i н
展 共	i @
占 佩	 ㄘ
占 苏	 默
战场 摆	驹初 \
战场 般	驹初 
战场 多	驹初 h
战场 上	驹初 W
战场 时	驹初 
战场 为	驹初 
战场 应	驹初 莱
战场 在	驹初 b
战车 和	驹ó M
战斗轰炸机 及	驹矮F稻 の
战斗轰炸机 是	驹矮F稻 O
战斗轰炸机 于	驹矮F稻 _
战斗轰炸机 在	驹矮F稻 b
战斗机 从	驹矮诀 q
战斗机 代	驹矮诀 N
战斗机 的	驹矮诀 
战斗机 等	驹矮诀 单
战斗机 给	驹矮诀 倒
战斗机 和	驹矮诀 M
战斗机 将	驹矮诀 N
战斗机 时	驹矮诀 
战斗机 也	驹矮诀 ]
战斗机 在	驹矮诀 b
战斗机 曾	驹矮诀 纯
战斗力 标	驹矮O 夹
战斗力 并	驹矮O }
战斗力 的	驹矮O 
战斗力 会	驹矮O |
战斗力 就	驹矮O N
战斗力 强	驹矮O j
战斗力 是	驹矮O O
战斗人员 中	驹矮H い
战斗 不	驹矮 ぃ
战斗 车	驹矮 ó
战斗 打	驹矮 ゴ
战斗 的	驹矮 
战斗 队	驹矮 钉
战斗 而	驹矮 τ
战斗 二	驹矮 G
战斗 过	驹矮 L
战斗 和	驹矮 M
战斗 后	驹矮 
战斗 换	驹矮 传
战斗 及	驹矮 の
战斗 里	驹矮 
战斗 仍	驹矮 ご
战斗 是	驹矮 O
战斗 条	驹矮 兵
战斗 性	驹矮 ┦
战斗 也	驹矮 ]
战斗 已	驹矮 w
战斗 员	驹矮 
战斗 在	驹矮 b
战斗 中	驹矮 い
战斗 准	驹矮 
战俘 并	驹R }
战况 将	驹p N
战况 时	驹p 
战况 是	驹p O
战略家 们	驹菠a 
战略战 术	驹菠驹 N
战胜 伦	驹秤 
战士 丰	驹h 伦
战士 家	驹h a
战士 万	驹h U
战术 的	驹N 
战术 核	驹N 
战术 和	驹N M
战天斗地 的	驹ぱ矮a 
战争 并	驹 }
站 并	 }
站 布	 ガ
站 发	 o
站 共	 @
绽 出	红 X
樟树 和	继攫 M
樟树 制	继攫 
章 敬	彻 q
张家口 市	iaf カ
张 并	i }
张 采	i 蹦
张 澄	i 坚
张 斗	i 矮
张 发	i o
张 丰	i 伦
张 家	i a
张 敬	i q
张 秋	i 
张 树	i 攫
张 万	i U
丈夫 并	Vひ }
障碍 并	毁锚 }
找出 个	тX 
找出 两	тX ㄢ
找出 了	тX F
找出 路	тX 隔
找出 其	тX ㄤ
找出 一	тX @
找到 并	т }
找到 万	т U
赵 发	化 o
赵 家	化 a
赵 树	化 攫
赵 婉	化 胞
照相 术	酚 N
兆 坚	 绊
肇事 共	Fㄆ @
召集 并	l栋 }
召开 并	l} }
哲学家 说	蹙钱a 弧
哲 共	 @
者 杯	 M
者 并	 }
者 发	 o
者 敬	 q
者 默	 q
者 签	 帽
者 术	 N
这些 树	oㄇ 攫
这 背	o I
这 并	o }
这 出	o X
这 丰	o 伦
这 家	o a
珍惜 和	帽 M
珍惜 来	帽 ㄓ
珍惜 水	帽 
珍惜 这	帽 o
珍惜 中	帽 い
珍 家	 a
真 并	u }
真 格	u 
真 树	u 攫
针布 厂	wガ t
针布 倒	wガ 
针布 的	wガ 
针布 都	wガ 常
针布 谁	wガ 街
针布 王	wガ 
针 并	w }
诊断 出	E_ X
诊疗 法	E励 k
诊疗 与	E励 P
诊 共	E @
震 塌	_ 厄
振 丰	 伦
振 殊	 
镇 出	马 X
镇 敬	马 q
镇 万	马 U
镇 溪	马 匪
蒸发 工	]o u
蒸发 和	]o M
蒸发 量	]o q
蒸馏水 和	]H M
蒸馏 和	]H M
蒸馏 酒	]H s
蒸蒸日上 的	]]らW 
蒸 出	] X
征收 额	┖Μ B
征税 额	┖| B
征 丰	┖ 伦
争斗 的	О 
争斗 而	О τ
争斗 如	О p
争斗 中	О い
争取 并	Ж }
争取 丰	Ж 伦
争先 发	Д o
争 出	 X
整顿 并	俱y }
整个 出	俱 X
整理 出	俱z X
整 妆	俱 З
正气 树	タ 攫
正如 布	タp ガ
正式宣布 道	タΑ钮 D
正式宣布 或	タΑ钮 ┪
正式 出	タΑ X
正式 签	タΑ 帽
正在 铲	タb 藐
正在 发	タb o
正在 家	タb a
正 发	タ o
正 树	タ 攫
政策 布	F郸 ガ
政府发言人 巴	F┎oēH ぺ
政府发言人 比	F┎oēH ゑ
政府发言人 对	F┎oēH 癸
政府发言人 福	F┎oēH 褐
政府发言人 克	F┎oēH J
政府发言人 说	F┎oēH 弧
政府发言人 谈	F┎oēH 酵
政府发言人 在	F┎oēH b
政府 并	F┎ }
政府 出	F┎ X
政府 发	F┎ o
政府 扶	F┎ н
政府 共	F┎ @
政府 签	F┎ 帽
政治家 办	Fva 快
政治家 的	Fva 
政治家 范	Fva S
政治家 和	Fva M
政治家 康	Fva d
政治家 们	Fva 
政治家 谈	Fva 酵
政治家 温	Fva 放
政治家 想	Fva Q
政治体制 的	Fv砰 
政治体制 和	Fv砰 M
政治体制 中	Fv砰 い
政治条件 的	Fv兵ン 
政治委员 万	Fve U
政 出	F X
政 共	F @
政 家	F a
郑州 签	G{ 帽
郑 家	G a
郑 万	G U
证明 并	谍 }
证书 并	谍 }
证 采	谍 蹦
证 婚	谍 B
支持 并	や }
支持 布	や ガ
支出 比	やX ゑ
支出 达	やX F
支出 大	やX j
支出 的	やX 
支出 等	やX 单
支出 高	やX 蔼
支出 将	やX N
支出 降	やX 
支出 就	やX N
支出 了	やX F
支出 少	やX ぶ
支出 数	やX 计
支出 为	やX 
支出 相	やX 
支出 小	やX p
支出 压	やX 溃
支出 也	やX ]
支出 由	やX パ
支出 约	やX 
支出 占	やX 
支出 中	やX い
支出 总	やX `
吱 格	s 
知道 家	竟D a
知名人士 共	睛WHh @
知情 等	颈 单
知情 人	颈 H
知识 丰	久 伦
知 出	 X
知 万	 U
脂 布	 ガ
之后 出	ぇ X
之后 签	ぇ 帽
之间 串	ぇ丁 
之间 签	ぇ丁 帽
之外 不	ぇ~ ぃ
之外 的	ぇ~ 
之外 赶	ぇ~ 话
之外 做	ぇ~ 暗
之 并	ぇ }
之 发	ぇ o
之 丰	ぇ 伦
之 家	ぇ a
之 秋	ぇ 
之 树	ぇ 攫
之 托	ぇ Λ
织布 工	麓ガ u
织布 涂	麓ガ 额
织锦 缎	麓A v
织 出	麓 X
职 并	戮 }
直布罗陀 的	渐霉 
直布罗陀 防	渐霉 
直肠 并	礁z }
直 逼	 G
直 扑	 汲
直 树	 攫
植树节 的	从攫` 
植树节 了	从攫` F
植树 场	从攫 初
植树 成	从攫 Θ
植树 从	从攫 q
植树 达	从攫 F
植树 的	从攫 
植树 等	从攫 单
植树 点	从攫 I
植树 访	从攫 X
植树 共	从攫 @
植树 和	从攫 M
植树 后	从攫 
植树 护	从攫 @
植树 近	从攫 
植树 良	从攫 }
植树 了	从攫 F
植树 迷	从攫 g
植树 热	从攫 荐
植树 日	从攫 ら
植树 时	从攫 
植树 外	从攫 ~
植树 已	从攫 w
植树 与	从攫 P
植树 约	从攫 
植树 在	从攫 b
植树 正	从攫 タ
植树 种	从攫 贺
植树 总	从攫 `
植 发	从 o
执行 采	磅 蹦
值 共	 @
指出 办	X 快
指出 不	X ぃ
指出 大	X j
指出 的	X 
指出 对	X 癸
指出 港	X 翠
指出 搞	X d
指出 后	X 
指出 救	X 毕
指出 来	X ㄓ
指出 了	X F
指出 美	X 
指出 南	X n
指出 商	X 坝
指出 是	X O
指出 我	X и
指出 需	X 惠
指出 要	X n
指出 在	X b
指出 折	X ч
指出 这	X o
指出 左	X オ
指导 万	旧 U
指挥家 聂	揣a 驴
指挥家 滕	揣a 拣
止不住 地	ゎぃ a
止步 不	ゎB ぃ
只得 采	uo 蹦
只是 苏	uO 默
只要 布	un ガ
只要 签	un 帽
只要 舍	un 
只有 万	uΤ U
只 发	u o
纸板 是	泉O O
纸 雕	 J
纸 术	 N
志 澄	в 坚
志 发	в o
志 共	в @
志 坚	в 绊
志 伦	в 
至今 共	埭 @
至上 万	埭W U
至 铲	 藐
至 格	 
置 扑	m 汲
制定 并	瞟w }
制定 出	瞟w X
制度 并	瞰 }
制 板	 O
制 并	 }
制 出	 X
制 发	 o
制 共	 @
制 帽	 U
智 家	醇 a
滞销 并	孩P }
治理 并	vz }
治疗 艾	v励 
治疗 被	v励 Q
治疗 不	v励 ぃ
治疗 达	v励 F
治疗 但	v励 
治疗 的	v励 
治疗 等	v励 单
治疗 非	v励 D
治疗 费	v励 O
治疗 干	v励 F
治疗 肝	v励 x
治疗 肛	v励 z
治疗 和	v励 M
治疗 后	v励 
治疗 或	v励 ┪
治疗 机	v励 诀
治疗 几	v励 X
治疗 假	v励 安
治疗 截	v励 I
治疗 抗	v励 к
治疗 科	v励 
治疗 了	v励 F
治疗 毛	v励 を
治疗 器	v励 竟
治疗 三	v励 T
治疗 上	v励 W
治疗 烧	v励 N
治疗 蛇	v励 D
治疗 时	v励 
治疗 是	v励 O
治疗 室	v励 
治疗 术	v励 N
治疗 他	v励 L
治疗 瘫	v励 捧
治疗 外	v励 ~
治疗 下	v励 U
治疗 新	v励 s
治疗 心	v励 み
治疗 也	v励 ]
治疗 一	v励 @
治疗 仪	v励 祸
治疗 乙	v励 A
治疗 者	v励 
治疗 植	v励 从
治 杯	v M
中波 签	いi 帽
中产阶级 的	い玻顶 
中产阶级 还	い玻顶 临
中毒 发	いr o
中国风 采	い瓣 蹦
中国人 并	い瓣H }
中国人 共	い瓣H @
中国 杯	い瓣 M
中国 并	い瓣 }
中国 出	い瓣 X
中国 扶	い瓣 н
中国 共	い瓣 @
中国 家	い瓣 a
中华人民共和国 从	い地Hチ@M瓣 q
中华人民共和国 的	い地Hチ@M瓣 
中华人民共和国 都	い地Hチ@M瓣 常
中华人民共和国 对	い地Hチ@M瓣 癸
中华人民共和国 和	い地Hチ@M瓣 M
中华人民共和国 境	い地Hチ@M瓣 挂
中华人民共和国 外	い地Hチ@M瓣 ~
中华人民共和国 为	い地Hチ@M瓣 
中华人民共和国 与	い地Hチ@M瓣 P
中华人民共和国 在	い地Hチ@M瓣 b
中华人民共和国 驻	い地Hチ@M瓣 n
中坚 持	い绊 
中美 出	い X
中美 苏	い 默
中心站 的	いみ 
中选 出	い匡 X
中央 发	いァ o
中央 苏	いァ 默
中医 丰	い洛 伦
中指 出	い X
中 板	い O
中 并	い }
中 出	い X
中 串	い 
中 发	い o
中 共	い @
中 汲	い V
中 漫	い 憨
中 扑	い 汲
中 苏	い 默
忠 家	┚ a
钟 发	牧 o
钟 家	牧 a
钟 敬	牧 q
钟 佩	牧 ㄘ
钟 万	牧 U
终止 采	沧ゎ 蹦
种树 的	贺攫 
种树 和	贺攫 M
种树 砍	贺攫 
种树 时	贺攫 
种树 要	贺攫 n
种树 栽	贺攫 
种树 种	贺攫 贺
种种 迹	贺贺 格
种子 出	贺l X
种族隔离 并	贺壁j瞒 }
种族隔离 斗	贺壁j瞒 矮
种 昂	贺 
种 出	贺 X
种 丰	贺 伦
种 共	贺 @
种 迹	贺 格
重兵 布	L ガ
重大 丰	j 伦
重点 布	I ガ
重点 堤	I 出
重点 扶	I н
重庆 共	y @
重视 并	跌 }
重新 签	s 帽
重要性 并	n┦ }
重要 发	n o
重 托	 Λ
仲 发	ヲ o
周年 丰	P~ 伦
周 出	P X
周 家	P a
州 发	{ o
州 敬	{ q
洲际 杯	w悔 M
珠 家	] a
株 树	 攫
朱 昂	Χ 
朱 布	Χ ガ
朱 家	Χ a
朱 敬	Χ q
朱 佩	Χ ㄘ
猪肉 串	睫ψ 
猪 杯	睫 M
猪 出	睫 X
逐步 并	vB }
逐渐 丰	v亥 伦
逐一 家	v@ a
逐 家	v a
竹板 架	λO [
竹子 丰	λl 伦
嘱 托	篷 Λ
主持 并	D }
主动 出	D笆 X
主动 扶	D笆 н
主人 翁	DH 
主任 并	Dヴ }
主任 格	Dヴ 
主任 苏	Dヴ 默
主任 托	Dヴ Λ
主任 邢	Dヴ ǚ
主任 珀	Dヴ 
主席台 的	Dux 
主席台 前	Dux e
主席台 上	Dux W
主席台 映	Dux M
主席团 常	Du刮 `
主席团 成	Du刮 Θ
主席团 处	Du刮 B
主席团 的	Du刮 
主席团 对	Du刮 癸
主席团 副	Du刮 捌
主席团 关	Du刮 闽
主席团 和	Du刮 M
主席团 互	Du刮 が
主席团 将	Du刮 N
主席团 是	Du刮 O
主席团 已	Du刮 w
主席团 因	Du刮 ]
主席团 在	Du刮 b
主席团 只	Du刮 u
主席团 中	Du刮 い
主席 阿	Du 
主席 埃	Du J
主席 艾	Du 
主席 安	Du w
主席 奥	Du 而
主席 巴	Du ぺ
主席 把	Du р
主席 白	Du フ
主席 鲍	Du j
主席 奔	Du b
主席 彼	Du ┘
主席 别	Du O
主席 博	Du 痴
主席 勃	Du k
主席 布	Du ガ
主席 蔡	Du 讲
主席 曹	Du 变
主席 策	Du 郸
主席 陈	Du 朝
主席 乘	Du 
主席 程	Du {
主席 楚	Du 贰
主席 从	Du q
主席 达	Du F
主席 打	Du ゴ
主席 德	Du w
主席 的	Du 
主席 等	Du 单
主席 邓	Du H
主席 迪	Du }
主席 蒂	Du 甫
主席 丁	Du B
主席 定	Du w
主席 董	Du 赋
主席 杜	Du 
主席 对	Du 癸
主席 多	Du h
主席 法	Du k
主席 范	Du S
主席 方	Du よ
主席 访	Du X
主席 菲	Du 滇
主席 费	Du O
主席 冯	Du 毒
主席 福	Du 褐
主席 弗	Du ケ
主席 府	Du ┎
主席 甘	Du ヌ
主席 冈	Du 
主席 高	Du 蔼
主席 戈	Du む
主席 葛	Du 腐
主席 格	Du 
主席 给	Du 倒
主席 根	Du 
主席 龚	Du 徘
主席 贡	Du ^
主席 谷	Du é
主席 关	Du 闽
主席 国	Du 瓣
主席 哈	Du 
主席 好	Du n
主席 和	Du M
主席 何	Du 
主席 贺	Du P
主席 很	Du 
主席 亨	Du 
主席 洪	Du x
主席 侯	Du J
主席 后	Du 
主席 胡	Du J
主席 还	Du 临
主席 黄	Du 独
主席 汇	Du 蹲
主席 或	Du ┪
主席 霍	Du N
主席 吉	Du N
主席 及	Du の
主席 季	Du u
主席 纪	Du 
主席 家	Du a
主席 加	Du [
主席 贾	Du 鸽
主席 兼	Du 
主席 将	Du N
主席 江	Du 
主席 焦	Du J
主席 金	Du 
主席 经	Du g
主席 就	Du N
主席 居	Du ~
主席 巨	Du エ
主席 绝	Du 荡
主席 卡	Du d
主席 康	Du d
主席 科	Du 
主席 克	Du J
主席 拉	Du ┰
主席 莱	Du 弟
主席 赖	Du 苦
主席 勒	Du 扒
主席 雷	Du p
主席 李	Du 
主席 利	Du Q
主席 两	Du ㄢ
主席 林	Du L
主席 令	Du O
主席 刘	Du B
主席 龙	Du s
主席 卢	Du c
主席 鲁	Du |
主席 吕	Du f
主席 罗	Du 霉
主席 玛	Du 嚎
主席 马	Du 皑
主席 曼	Du 耙
主席 毛	Du を
主席 每	Du C
主席 蒙	Du X
主席 米	Du μ
主席 莫	Du 馋
主席 姆	Du i
主席 穆	Du p
主席 纳	Du 
主席 内	Du ず
主席 倪	Du 
主席 尼	Du ェ
主席 年	Du ~
主席 聂	Du 驴
主席 努	Du V
主席 诺	Du 空
主席 帕	Du ┈
主席 派	Du 
主席 潘	Du 硷
主席 培	Du 蚌
主席 彭	Du ^
主席 皮	Du ブ
主席 朴	Du Φ
主席 普	Du 炊
主席 钱	Du 窥
主席 乔	Du 踌
主席 亲	Du 克
主席 秦	Du 
主席 请	Du 叫
主席 邱	Du 
主席 让	Du 琵
主席 热	Du 荐
主席 人	Du H
主席 荣	Du a
主席 若	Du Y
主席 萨	Du 履
主席 赛	Du 辽
主席 商	Du 坝
主席 绍	Du 残
主席 舍	Du 
主席 设	Du ]
主席 沈	Du H
主席 石	Du ホ
主席 是	Du O
主席 说	Du 弧
主席 斯	Du 吹
主席 苏	Du 默
主席 素	Du 
主席 孙	Du ]
主席 谭	Du 糜
主席 谈	Du 酵
主席 坦	Du Z
主席 特	Du S
主席 题	Du D
主席 铁	Du K
主席 听	Du 钮
主席 同	Du P
主席 托	Du Λ
主席 瓦	Du ニ
主席 万	Du U
主席 王	Du 
主席 威	Du 
主席 韦	Du 
主席 为	Du 
主席 维	Du 蝴
主席 问	Du 拜
主席 沃	Du U
主席 吴	Du d
主席 武	Du Z
主席 伍	Du ヮ
主席 西	Du 
主席 下	Du U
主席 夏	Du L
主席 向	Du V
主席 徐	Du }
主席 许	Du \
主席 雅	Du 懂
主席 亚	Du ㄈ
主席 杨	Du 法
主席 扬	Du 喘
主席 耶	Du C
主席 叶	Du 腑
主席 一	Du @
主席 伊	Du レ
主席 遗	Du 框
主席 易	Du 
主席 英	Du ^
主席 由	Du パ
主席 又	Du S
主席 于	Du _
主席 余	Du E
主席 与	Du P
主席 袁	Du K
主席 约	Du 
主席 在	Du b
主席 曾	Du 纯
主席 詹	Du 糕
主席 章	Du 彻
主席 张	Du i
主席 赵	Du 化
主席 这	Du o
主席 郑	Du G
主席 之	Du ぇ
主席 职	Du 戮
主席 致	Du P
主席 中	Du い
主席 周	Du P
主席 朱	Du Χ
主席 庄	Du 缠
主席 佐	Du 
主席 作	Du @
主席 荻	Du 昌
主要问题 并	Dn拜D }
主治医师 苏	Dv洛v 默
主 仆	D 共
著作 出	帝@ X
著作 共	帝@ @
著 出	帝 X
著 斗	帝 矮
著 发	帝 o
著 丰	帝 伦
著 家	帝 a
著 漫	帝 憨
著 术	帝 N
著 树	帝 攫
著 苏	帝 默
著 万	帝 U
铸铁 焊	疟K k
铸造 出	疟y X
铸 板	疟 O
筑 出	诞 X
筑 堤	诞 出
筑 家	诞 a
住家 较	懋a 耕
注入 并	`J }
注意事项 和	`Nㄆ兜 M
驻 布	n ガ
驻 苏	n 默
抓住 发	ъ o
抓 出	ъ X
抓 共	ъ @
抓 扑	ъ 汲
拽 出	 X
专家 按	Ma 
专家 巴	Ma ぺ
专家 把	Ma р
专家 便	Ma K
专家 测	Ma 代
专家 陈	Ma 朝
专家 称	Ma 嘿
专家 持	Ma 
专家 慈	Ma O
专家 单	Ma 虫
专家 当	Ma 讽
专家 到	Ma 
专家 的	Ma 
专家 等	Ma 单
专家 抵	Ma ╄
专家 杜	Ma 
专家 对	Ma 癸
专家 多	Ma h
专家 冯	Ma 毒
专家 赴	Ma u
专家 各	Ma U
专家 耿	Ma 
专家 共	Ma @
专家 古	Ma j
专家 郭	Ma 尝
专家 哈	Ma 
专家 好	Ma n
专家 核	Ma 
专家 和	Ma M
专家 呼	Ma I
专家 胡	Ma J
专家 还	Ma 临
专家 黄	Ma 独
专家 获	Ma 莉
专家 及	Ma の
专家 级	Ma 
专家 几	Ma X
专家 鉴	Ma 懦
专家 将	Ma N
专家 焦	Ma J
专家 经	Ma g
专家 就	Ma N
专家 举	Ma |
专家 均	Ma А
专家 开	Ma }
专家 考	Ma σ
专家 孔	Ma ふ
专家 拉	Ma ┰
专家 来	Ma ㄓ
专家 李	Ma 
专家 林	Ma L
专家 刘	Ma B
专家 鲁	Ma |
专家 论	Ma 阶
专家 马	Ma 皑
专家 麦	Ma 沉
专家 茅	Ma T
专家 们	Ma 
专家 尼	Ma ェ
专家 评	Ma 蝶
专家 钱	Ma 窥
专家 秦	Ma 
专家 尚	Ma |
专家 邵	Ma 
专家 史	Ma v
专家 是	Ma O
专家 试	Ma 刚
专家 水	Ma 
专家 说	Ma 弧
专家 谈	Ma 酵
专家 陶	Ma 吵
专家 汪	Ma L
专家 王	Ma 
专家 围	Ma 瞅
专家 为	Ma 
专家 闻	Ma D
专家 吴	Ma d
专家 伍	Ma ヮ
专家 夏	Ma L
专家 谢	Ma 谅
专家 新	Ma s
专家 研	Ma 
专家 要	Ma n
专家 也	Ma ]
专家 一	Ma @
专家 已	Ma w
专家 用	Ma ノ
专家 于	Ma _
专家 俞	Ma \
专家 誉	Ma A
专家 在	Ma b
专家 曾	Ma 纯
专家 赵	Ma 化
专家 之	Ma ぇ
专家 周	Ma P
专家 朱	Ma Χ
专家 逐	Ma v
专家 组	Ma 舱
专家 作	Ma @
专家 窦	Ma u
专栏作家 库	M逆@a w
专门委员会 成	Me| Θ
专门委员会 的	Me| 
专门委员会 对	Me| 癸
专门委员会 副	Me| 捌
专门委员会 和	Me| M
专门委员会 汇	Me| 蹲
专门委员会 来	Me| ㄓ
专门委员会 是	Me| O
专门委员会 要	Me| n
专门委员会 在	Me| b
专门委员会 专	Me| M
专门知识 的	M久 
专门 编	M s
专门 拨	M 挤
专门 冲	M R
专门 抽	M ┾
专门 从	M q
专门 党	M 囊
专门 到	M 
专门 的	M 
专门 调	M 秸
专门 对	M 癸
专门 发	M o
专门 搞	M d
专门 给	M 倒
专门 寄	M H
专门 家	M a
专门 接	M 钡
专门 就	M N
专门 举	M |
专门 来	M ㄓ
专门 派	M 
专门 请	M 叫
专门 去	M h
专门 谈	M 酵
专门 团	M 刮
专门 为	M 
专门 向	M V
专门 写	M g
专门 以	M H
专门 用	M ノ
专门 在	M b
专门 找	M т
专门 走	M ǐ
专门 组	M 舱
专门 做	M 暗
专题 发	MD o
专业 扑	M~ 汲
专用 树	Mノ 攫
专员 托	M Λ
专 发	M o
转发 的	锣o 
转发 关	锣o 闽
转发 了	锣o F
转发 中	锣o い
转发 总	锣o `
撰写 出	级g X
庄家 富	缠a I
庄 串	缠 
装甲兵 副	杆ヒL 捌
装甲兵 某	杆ヒL Y
妆 的	З 
妆 点	З I
妆 素	З 
妆 玉	З ド
状况 并	p }
状况 不	p ぃ
状况 差	p t
状况 大	p j
状况 倒	p 
状况 到	p 
状况 的	p 
状况 都	p 常
状况 更	p 
状况 勾	p つ
状况 和	p M
状况 横	p 绢
状况 还	p 临
状况 及	p の
状况 将	p N
状况 尽	p 荷
状况 看	p 
状况 仍	p ご
状况 深	p `
状况 时	p 
状况 是	p O
状况 同	p P
状况 也	p ]
状况 已	p w
状况 有	p Τ
状况 与	p P
状况 再	p A
状况 在	p b
状况 则	p h
状况 正	p タ
状况 中	p い
状况 最	p 程
状况 亟	p E
状态 并	A }
追悼会 和	l饱| M
追悼会 上	l饱| W
追悼会 为	l饱| 
追悼会 在	l饱| b
追求 并	lD }
追思礼拜 和	l渎Й M
追溯 两	l饭 ㄢ
追随者 的	lH 
追随 党	lH 囊
追随 著	lH 帝
准 格	 
准 焊	 k
茁壮 的	_Ё 
兹 布	 ガ
咨询 并	t高 }
资本家 的	戈セa 
资本家 就	戈セa N
资本家 来	戈セa ㄓ
资本家 在	戈セa b
资本家 这	戈セa o
资格审查委员会 对	戈婕fde| 癸
资格审查委员会 关	戈婕fde| 闽
资格审查委员会 经	戈婕fde| g
资格审查委员会 就	戈婕fde| N
资格 被	戈 Q
资格 的	戈 
资格 和	戈 M
资格 后	戈 
资格 及	戈 の
资格 来	戈 ㄓ
资格 老	戈 ρ
资格 了	戈 F
资格 评	戈 蝶
资格 赛	戈 辽
资格 时	戈 
资格 要	戈 n
资格 者	戈 
资格 最	戈 程
资金 并	戈 }
资金 共	戈 @
资料库 并	戈飘w }
资料 并	戈 }
资料 丰	戈 伦
资源 采	戈方 蹦
资源 出	戈方 X
资源 丰	戈方 伦
资助 并	戈U }
资助 家	戈U a
资 并	戈 }
资 额	戈 B
仔细 地	J灿 a
仔细 俯	J灿 
仔细 看	J灿 
仔细 算	J灿 衡
仔细 踏	J灿 今
仔细 听	J灿 钮
仔细 细	J灿 灿
仔细 聆	J灿 测
子系统 已	lt参 w
子 昂	l 
子 板	l O
子 并	l }
子 布	l ガ
子 恼	l o
自从 苏	郾q 默
自发 布	鄣o ガ
自发 的	鄣o 
自发 地	鄣o a
自发 举	鄣o |
自发 裂	鄣o 吊
自发 为	鄣o 
自发 现	鄣o {
自发 组	鄣o 舱
自古以来 就	邾jHㄓ N
自己 出	郅v X
自己 丰	郅v 伦
自己 家	郅v a
自家 办	郛a 快
自家 的	郛a 
自家 三	郛a T
自家 田	郛a バ
自家 也	郛a ]
自觉 发	勰 o
自民党 并	邾聊 }
自然 发	鄣M o
自身 丰	郇 伦
自由化 斗	邾绚 矮
自治区 共	郦v跋 @
自 并	 }
自 树	 攫
字画 敬	re q
字迹 工	r格 u
综合 采	侯X 蹦
综合 扑	侯X 汲
综 采	侯 蹦
总部 发	`场 o
总干事 苏	`Fㄆ 默
总工程师 陈	`u{v 朝
总工程师 傅	`u{v 撑
总工程师 郭	`u{v 尝
总工程师 和	`u{v M
总工程师 刘	`u{v B
总工程师 章	`u{v 彻
总工程师 张	`u{v i
总公司 布	`そq ガ
总公司 筹	`そq w
总公司 从	`そq q
总公司 的	`そq 
总公司 等	`そq 单
总公司 都	`そq 常
总公司 二	`そq G
总公司 共	`そq @
总公司 和	`そq M
总公司 还	`そq 临
总公司 几	`そq X
总公司 将	`そq N
总公司 廊	`そq Y
总公司 卢	`そq c
总公司 潘	`そq 硷
总公司 签	`そq 帽
总公司 是	`そq O
总公司 所	`そq ┮
总公司 谈	`そq 酵
总公司 王	`そq 
总公司 物	`そq 
总公司 向	`そq V
总公司 写	`そq g
总公司 兴	`そq 砍
总公司 研	`そq 
总公司 一	`そq @
总公司 已	`そq w
总公司 与	`そq P
总公司 在	`そq b
总公司 正	`そq タ
总公司 逐	`そq v
总公司 主	`そq D
总公司 组	`そq 舱
总共 八	`@ K
总共 才	`@ ~
总共 将	`@ N
总共 可	`@ i
总共 欠	`@ ろ
总共 为	`@ 
总共 献	`@ m
总共 向	`@ V
总共 销	`@ P
总共 有	`@ Τ
总共 在	`@ b
总管 之	`恨 ぇ
总结 并	`挡 }
总结 采	`挡 蹦
总结 出	`挡 X
总结 发	`挡 o
总经理 格	`gz 
总经理 邢	`gz ǚ
总理 布	`z ガ
总理 出	`z X
总理 家	`z a
总理 伦	`z 
总理 佩	`z ㄘ
总理 苏	`z 默
总理 托	`z Λ
总领事 翁	`烩ㄆ 
总司令 布	`qO ガ
总体 布	`砰 ガ
总统 杯	`参 M
总统 并	`参 }
总统 布	`参 ガ
总统 出	`参 X
总统 共	`参 @
总统 佩	`参 ㄘ
总统 苏	`参 默
总 出	` X
总 额	` B
总 发	` o
邹 家	Q a
走出去 的	ǐXh 
走出 崔	ǐX Z
走出 的	ǐX 
走出 低	ǐX C
走出 关	ǐX 闽
走出 馆	ǐX ]
走出 国	ǐX 瓣
走出 检	ǐX 浪
走出 敬	ǐX q
走出 来	ǐX ㄓ
走出 牢	ǐX c
走出 了	ǐX F
走出 校	ǐX 
走出 一	ǐX @
走出 营	ǐX 犁
走出 院	ǐX |
走出 周	ǐX P
走到 万	ǐ U
走下 车	ǐU ó
走下 去	ǐU h
走 家	ǐ a
走 苏	ǐ 默
奏 出	 X
租赁 额	哺 B
租赁 扶	哺 н
租 发	 o
足不出户 便	ìぃXめ K
足迹 遍	ì格 M
足迹 到	ì格 
足迹 的	ì格 
足迹 中	ì格 い
足迹 走	ì格 ǐ
足球 出	ìy X
祖国 万	瓣 U
祖 伦	 
组成 扶	舱Θ н
组织 并	舱麓 }
组织 布	舱麓 ガ
组织 共	舱麓 @
组织 签	舱麓 帽
组织 万	舱麓 U
组 并	舱 }
组 出	舱 X
组 共	舱 @
钻 采	p 蹦
钻 出	p X
嘴唇 发	LB o
最近 出	程 X
最近 共	程 @
最先 采	程 蹦
最终 并	程沧 }
最 丰	程 伦
尊敬 的	Lq 
尊敬 地	Lq a
尊敬 和	Lq M
做文章 在	暗ゅ彻 b
做 出	暗 X
作出 不	@X ぃ
作出 从	@X q
作出 的	@X 
作出 复	@X _
作出 更	@X 
作出 关	@X 闽
作出 过	@X L
作出 何	@X 
作出 很	@X 
作出 将	@X N
作出 较	@X 耕
作出 开	@X }
作出 了	@X F
作出 全	@X 
作出 什	@X ぐ
作出 他	@X L
作出 无	@X L
作出 向	@X V
作出 新	@X s
作出 一	@X @
作出 应	@X 莱
作出 有	@X Τ
作出 这	@X o
作出 整	@X 俱
作出 专	@X M
作出 准	@X 
作法 并	@k }
作家 巴	@a ぺ
作家 班	@a Z
作家 草	@a 
作家 陈	@a 朝
作家 从	@a q
作家 大	@a j
作家 的	@a 
作家 都	@a 常
作家 对	@a 癸
作家 冯	@a 毒
作家 高	@a 蔼
作家 和	@a M
作家 获	@a 莉
作家 及	@a の
作家 将	@a N
作家 卡	@a d
作家 柯	@a _
作家 李	@a 
作家 林	@a L
作家 刘	@a B
作家 路	@a 隔
作家 陆	@a 嘲
作家 罗	@a 霉
作家 们	@a 
作家 聂	@a 驴
作家 去	@a h
作家 却	@a o
作家 群	@a s
作家 三	@a T
作家 属	@a 妮
作家 说	@a 弧
作家 苏	@a 默
作家 王	@a 
作家 为	@a 
作家 夏	@a L
作家 杨	@a 法
作家 也	@a ]
作家 以	@a H
作家 又	@a S
作家 之	@a ぇ
作家 中	@a い
作家 总	@a `
作品 共	@~ @
作曲家 戈	@Ρa む
作曲家 关	@Ρa 闽
作曲家 获	@Ρa 莉
作曲家 刘	@Ρa B
作曲家 谱	@Ρa 眯
作曲家 王	@Ρa 
作曲家 为	@Ρa 
作曲家 言	@Ρa ē
作曲家 周	@Ρa P
作为 扶	@ н
作为 苏	@ 默
作物 丰	@ 伦
作用 发	@ノ o
作者 丰	@ 伦
坐冷板凳 对	ГNO构 癸
座谈会 并	y酵| }
座谈会 共	y酵| @
座谈 并	y酵 }
座谈 共	y酵 @
座位 并	y }
座 采	y 蹦
座 敬	y q
伉俪 杯	リ淖 M
凫 溪	囗 匪
诙谐 的	纲坑 
诙谐 地	纲坑 a
邰 万	妥 U
圩 堤	f 出
圳 签	` 帽
圳 托	` Λ
芙蓉 树	芑T 攫
莅 会	Y |
莅 临	Y {
莅 去	Y h
咄咄逼人 的	FFGH 
嵘 出	蜡 X
庾 澄	h 坚
憧憬 著	讥缉 帝
闫 家	E a
阖 家	麦 a
遴选 出	款匡 X
妍 斗	О 矮
婷 并	@ }
尕 布	稍 ガ
缫 出	b X
珀 蒂	 甫
珀 和	 M
珀 妮	 g
琦 扑	a 汲
琥珀 烟	[ 废
栎 树	R 攫
桦树 甸	眷攫 l
桉 树	眼 攫
檐 布	姥 ガ
昊 苏	 默
稔 秋	Z 
癫痫 疗	碰w 励
褚 敬	u q
翡翠 雕	BA J
踱 出	库 X
鬓 发	K o
鼬 舍	^ 
